[A-Z][a-zA-Z]+ activist	TITLE	MISC	1
US	COUNTRY	LOCATION	1
AL	STATE_OR_PROVINCE	LOCATION	1
AK	STATE_OR_PROVINCE	LOCATION	1
AS	STATE_OR_PROVINCE	LOCATION	1
AZ	STATE_OR_PROVINCE	LOCATION	1
AR	STATE_OR_PROVINCE	LOCATION	1
CA	STATE_OR_PROVINCE	LOCATION	1
CO	STATE_OR_PROVINCE	LOCATION	1
CT	STATE_OR_PROVINCE	LOCATION	1
DE	STATE_OR_PROVINCE	LOCATION	1
DC	STATE_OR_PROVINCE	LOCATION	1
FL	STATE_OR_PROVINCE	LOCATION	1
GA	STATE_OR_PROVINCE	LOCATION	1
GU	STATE_OR_PROVINCE	LOCATION	1
HI	STATE_OR_PROVINCE	LOCATION	1
ID	STATE_OR_PROVINCE	LOCATION	1
IL	STATE_OR_PROVINCE	LOCATION	1
IN	STATE_OR_PROVINCE	LOCATION	1
IA	STATE_OR_PROVINCE	LOCATION	1
KS	STATE_OR_PROVINCE	LOCATION	1
KY	STATE_OR_PROVINCE	LOCATION	1
LA	STATE_OR_PROVINCE	LOCATION	1
ME	STATE_OR_PROVINCE	LOCATION	1
MD	STATE_OR_PROVINCE	LOCATION	1
MA	STATE_OR_PROVINCE	LOCATION	1
MI	STATE_OR_PROVINCE	LOCATION	1
MN	STATE_OR_PROVINCE	LOCATION	1
MS	STATE_OR_PROVINCE	LOCATION	1
MO	STATE_OR_PROVINCE	LOCATION	1
MT	STATE_OR_PROVINCE	LOCATION	1
NE	STATE_OR_PROVINCE	LOCATION	1
NV	STATE_OR_PROVINCE	LOCATION	1
NH	STATE_OR_PROVINCE	LOCATION	1
NJ	STATE_OR_PROVINCE	LOCATION	1
NM	STATE_OR_PROVINCE	LOCATION	1
NY	STATE_OR_PROVINCE	LOCATION	1
NC	STATE_OR_PROVINCE	LOCATION	1
ND	STATE_OR_PROVINCE	LOCATION	1
OH	STATE_OR_PROVINCE	LOCATION	1
OK	STATE_OR_PROVINCE	LOCATION	1
OR	STATE_OR_PROVINCE	LOCATION	1
PA	STATE_OR_PROVINCE	LOCATION	1
PR	STATE_OR_PROVINCE	LOCATION	1
RI	STATE_OR_PROVINCE	LOCATION	1
SC	STATE_OR_PROVINCE	LOCATION	1
SD	STATE_OR_PROVINCE	LOCATION	1
TN	STATE_OR_PROVINCE	LOCATION	1
TX	STATE_OR_PROVINCE	LOCATION	1
UT	STATE_OR_PROVINCE	LOCATION	1
VT	STATE_OR_PROVINCE	LOCATION	1
VI	STATE_OR_PROVINCE	LOCATION	1
VA	STATE_OR_PROVINCE	LOCATION	1
WA	STATE_OR_PROVINCE	LOCATION	1
WV	STATE_OR_PROVINCE	LOCATION	1
WI	STATE_OR_PROVINCE	LOCATION	1
WY	STATE_OR_PROVINCE	LOCATION	1
AB	STATE_OR_PROVINCE	LOCATION	1
BC	STATE_OR_PROVINCE	LOCATION	1
MB	STATE_OR_PROVINCE	LOCATION	1
NB	STATE_OR_PROVINCE	LOCATION	1
NL	STATE_OR_PROVINCE	LOCATION	1
NT	STATE_OR_PROVINCE	LOCATION	1
NS	STATE_OR_PROVINCE	LOCATION	1
NU	STATE_OR_PROVINCE	LOCATION	1
ON	STATE_OR_PROVINCE	LOCATION	1
PE	STATE_OR_PROVINCE	LOCATION	1
QC	STATE_OR_PROVINCE	LOCATION	1
SK	STATE_OR_PROVINCE	LOCATION	1
YT	STATE_OR_PROVINCE	LOCATION	1
Ala\.?	STATE_OR_PROVINCE	LOCATION	1
Alaska	STATE_OR_PROVINCE	LOCATION	1
Ariz\.?	STATE_OR_PROVINCE	LOCATION	1
Ark\.?	STATE_OR_PROVINCE	LOCATION	1
Calif\.?	STATE_OR_PROVINCE	LOCATION	1
Colo\.?	STATE_OR_PROVINCE	LOCATION	1
Conn\.?	STATE_OR_PROVINCE	LOCATION	1
Del\.?	STATE_OR_PROVINCE	LOCATION	1
Columbia	STATE_OR_PROVINCE	LOCATION	1
Fla\.?	STATE_OR_PROVINCE	LOCATION	1
Ga\.?	STATE_OR_PROVINCE	LOCATION	1
Hawaii	STATE_OR_PROVINCE	LOCATION	1
Idaho	STATE_OR_PROVINCE	LOCATION	1
Ill\.?	STATE_OR_PROVINCE	LOCATION	1
Ind\.?	STATE_OR_PROVINCE	LOCATION	1
Iowa	STATE_OR_PROVINCE	LOCATION	1
Kans\.?	STATE_OR_PROVINCE	LOCATION	1
Ky\.?	STATE_OR_PROVINCE	LOCATION	1
La\.?	STATE_OR_PROVINCE	LOCATION	1
Maine	STATE_OR_PROVINCE	LOCATION	1
Md\.?	STATE_OR_PROVINCE	LOCATION	1
Mass\.?	STATE_OR_PROVINCE	LOCATION	1
Mich\.?	STATE_OR_PROVINCE	LOCATION	1
Minn\.?	STATE_OR_PROVINCE	LOCATION	1
Miss\.?	STATE_OR_PROVINCE	LOCATION	1
Mo\.?	STATE_OR_PROVINCE	LOCATION	1
Mont\.?	STATE_OR_PROVINCE	LOCATION	1
Neb\.?	STATE_OR_PROVINCE	LOCATION	1
Nev\.?	STATE_OR_PROVINCE	LOCATION	1
N\.?H\.?	STATE_OR_PROVINCE	LOCATION	1
N\.?J\.?	STATE_OR_PROVINCE	LOCATION	1
N\.?M\.?	STATE_OR_PROVINCE	LOCATION	1
N\.?Y\.?	STATE_OR_PROVINCE	LOCATION	1
N\.?C\.?	STATE_OR_PROVINCE	LOCATION	1
N\.?D\.?	STATE_OR_PROVINCE	LOCATION	1
Ohio	STATE_OR_PROVINCE	LOCATION	1
Okla\.?	STATE_OR_PROVINCE	LOCATION	1
Ore\.?	STATE_OR_PROVINCE	LOCATION	1
P[Aa]\.?	STATE_OR_PROVINCE	LOCATION	1
R\.?I\.?	STATE_OR_PROVINCE	LOCATION	1
S\.?C\.?	STATE_OR_PROVINCE	LOCATION	1
S\.?D\.?	STATE_OR_PROVINCE	LOCATION	1
Tenn\.?	STATE_OR_PROVINCE	LOCATION	1
Tex\.?	STATE_OR_PROVINCE	LOCATION	1
Utah	STATE_OR_PROVINCE	LOCATION	1
V[tT]\.?	STATE_OR_PROVINCE	LOCATION	1
V[aA]\.?	STATE_OR_PROVINCE	LOCATION	1
Wash\.?	STATE_OR_PROVINCE	LOCATION	1
W\.?V\.?	STATE_OR_PROVINCE	LOCATION	1
Wis\.?	STATE_OR_PROVINCE	LOCATION	1
Wyo\.?	STATE_OR_PROVINCE	LOCATION	1
Alta\.?	STATE_OR_PROVINCE	LOCATION	1
B\.?C\.?	STATE_OR_PROVINCE	LOCATION	1
Man\.	STATE_OR_PROVINCE	LOCATION	1
N\.?B\.?	STATE_OR_PROVINCE	LOCATION	1
N\.?F\.?	STATE_OR_PROVINCE	LOCATION	1
N\.?W\.?T\.?	STATE_OR_PROVINCE	LOCATION	1
N\.?S\.?	STATE_OR_PROVINCE	LOCATION	1
Nunavut	STATE_OR_PROVINCE	LOCATION	1
Ont\.?	STATE_OR_PROVINCE	LOCATION	1
P\.?E\.?I\.?	STATE_OR_PROVINCE	LOCATION	1
P\.?Q\.?	STATE_OR_PROVINCE	LOCATION	1
Qu√©\.?	STATE_OR_PROVINCE	LOCATION	1
Sask\.?	STATE_OR_PROVINCE	LOCATION	1
Yuk\.?	STATE_OR_PROVINCE	LOCATION	1
Y\.?T\.?	STATE_OR_PROVINCE	LOCATION	1
L\.?A\.?	CITY	LOCATION	1
S\.?F\.?	CITY	LOCATION	1
S\.?J\.?	CITY	LOCATION	1
N\.?Y\.?	CITY	LOCATION	1
CEO	TITLE	1
Superior	TITLE	1
Primate	TITLE	1
Gen\.? [Oo]f [Tt]he Army	TITLE	1
Gen\.?	TITLE	1
Lt\.? Gen\.?	TITLE	2
Maj\.? Gen\.?	TITLE	2
Brig\.? Gen\.?	TITLE	2
Col\.	TITLE	1
Lt\. Col\.	TITLE	2
Maj\.?	TITLE	1
Major	TITLE	1
Capt\.?	TITLE	1
Captain	TITLE	1
1st Lt\.?	TITLE	1
2nd Lt\.?	TITLE	1
Sgt\. Maj\.	TITLE	2
1st Sgt\.?	TITLE	2
Sgt\.? 1st Class	TITLE	3
Sgt\.?	TITLE	1
Cpl\.?	TITLE	1
Pvt\.?	TITLE	1
Pvt\.? [0-9].?.? [Cc]lass	TITLE	3
P[fF][cC]	TITLE	1
Private	TITLE	1
Private [0-9].?.? [Cc]lass	TITLE	3
Private [Ff]irst [Cc]lass	TITLE	3
Private [Ss]econd [Cc]lass	TITLE	3
Fleet Adm\.?	TITLE	2
Adm\.?	TITLE	1
Vice Adm\.?	TITLE	1
Rear Adm\.?	TITLE	1
Cmdr\.?	TITLE	1
Lt\.? Cmdr\.?	TITLE	2
Lt\.?	TITLE	1
Rev\.?	TITLE	1
Acevedo	CITY	LOCATION	1
Aguilar	CITY	LOCATION	1
Allen	CITY	LOCATION	1
Alvarado	CITY	LOCATION	1
Anderson	CITY	LOCATION	1
Andrews	CITY	LOCATION	1
Armstrong	CITY	LOCATION	1
Arnold	CITY	LOCATION	1
Atkinson	CITY	LOCATION	1
Austin	CITY	LOCATION	1
Avila	CITY	LOCATION	1
Ayala	CITY	LOCATION	1
Baker	CITY	LOCATION	1
Baldwin	CITY	LOCATION	1
Barry	CITY	LOCATION	1
Bartlett	CITY	LOCATION	1
Bautista	CITY	LOCATION	1
Bell	CITY	LOCATION	1
Beltran	CITY	LOCATION	1
Bentley	CITY	LOCATION	1
Benton	CITY	LOCATION	1
Berg	CITY	LOCATION	1
Berger	CITY	LOCATION	1
Blackburn	CITY	LOCATION	1
Bolton	CITY	LOCATION	1
Boone	CITY	LOCATION	1
Bowen	CITY	LOCATION	1
Boyle	CITY	LOCATION	1
Bradford	CITY	LOCATION	1
Bradley	CITY	LOCATION	1
Bray	CITY	LOCATION	1
Brewer	CITY	LOCATION	1
Brooks	CITY	LOCATION	1
Bryan	CITY	LOCATION	1
Bryant	CITY	LOCATION	1
Buchanan	CITY	LOCATION	1
Burke	CITY	LOCATION	1
Burton	CITY	LOCATION	1
Butler	CITY	LOCATION	1
Cabrera	CITY	LOCATION	1
Caldwell	CITY	LOCATION	1
Calhoun	CITY	LOCATION	1
Campbell	CITY	LOCATION	1
Campos	CITY	LOCATION	1
Cantu	CITY	LOCATION	1
Cardenas	CITY	LOCATION	1
Carney	CITY	LOCATION	1
Carroll	CITY	LOCATION	1
Carson	CITY	LOCATION	1
Castillo	CITY	LOCATION	1
Castro	CITY	LOCATION	1
Cervantes	CITY	LOCATION	1
Chandler	CITY	LOCATION	1
Chase	CITY	LOCATION	1
Cisneros	CITY	LOCATION	1
Clark	CITY	LOCATION	1
Clayton	CITY	LOCATION	1
Colon	CITY	LOCATION	1
Compton	CITY	LOCATION	1
Conner	CITY	LOCATION	1
Conway	CITY	LOCATION	1
Cordova	CITY	LOCATION	1
Cortez	CITY	LOCATION	1
Craig	CITY	LOCATION	1
Crosby	CITY	LOCATION	1
Cruz	CITY	LOCATION	1
Cuevas	CITY	LOCATION	1
Curry	CITY	LOCATION	1
Dalton	CITY	LOCATION	1
Davenport	CITY	LOCATION	1
David	CITY	LOCATION	1
Davidson	CITY	LOCATION	1
Davila	CITY	LOCATION	1
Davis	CITY	LOCATION	1
Dawson	CITY	LOCATION	1
Delgado	CITY	LOCATION	1
Dennis	CITY	LOCATION	1
Diaz	CITY	LOCATION	1
Dickson	CITY	LOCATION	1
Dillon	CITY	LOCATION	1
Dixon	CITY	LOCATION	1
Douglas	CITY	LOCATION	1
Duarte	CITY	LOCATION	1
Dudley	CITY	LOCATION	1
Duncan	CITY	LOCATION	1
Dunn	CITY	LOCATION	1
Duran	CITY	LOCATION	1
Durham	CITY	LOCATION	1
Dyer	CITY	LOCATION	1
Escobar	CITY	LOCATION	1
Evans	CITY	LOCATION	1
Everett	CITY	LOCATION	1
Ewing	CITY	LOCATION	1
Ferguson	CITY	LOCATION	1
Fernandez	CITY	LOCATION	1
Flores	CITY	LOCATION	1
Forbes	CITY	LOCATION	1
Foster	CITY	LOCATION	1
Franklin	CITY	LOCATION	1
Frederick	CITY	LOCATION	1
Garcia	CITY	LOCATION	1
Gardner	CITY	LOCATION	1
Garner	CITY	LOCATION	1
Gay	CITY	LOCATION	1
George	CITY	LOCATION	1
Gilbert	CITY	LOCATION	1
Golden	CITY	LOCATION	1
Gomez	CITY	LOCATION	1
Gonzales	CITY	LOCATION	1
Gonzalez	CITY	LOCATION	1
Graham	CITY	LOCATION	1
Gray	CITY	LOCATION	1
Green	CITY	LOCATION	1
Greer	CITY	LOCATION	1
Griffin	CITY	LOCATION	1
Griffith	CITY	LOCATION	1
Guerrero	CITY	LOCATION	1
Gutierrez	CITY	LOCATION	1
Hamilton	CITY	LOCATION	1
Hammond	CITY	LOCATION	1
Hampton	CITY	LOCATION	1
Hanna	CITY	LOCATION	1
Hanson	CITY	LOCATION	1
Harper	CITY	LOCATION	1
Harrison	CITY	LOCATION	1
Harvey	CITY	LOCATION	1
Hatfield	CITY	LOCATION	1
Hayden	CITY	LOCATION	1
Hays	CITY	LOCATION	1
Henderson	CITY	LOCATION	1
Herrera	CITY	LOCATION	1
Hinton	CITY	LOCATION	1
Ho	CITY	LOCATION	1
Hobbs	CITY	LOCATION	1
Holden	CITY	LOCATION	1
Holland	CITY	LOCATION	1
Holt	CITY	LOCATION	1
Hoover	CITY	LOCATION	1
Hopkins	CITY	LOCATION	1
Horn	CITY	LOCATION	1
Houston	CITY	LOCATION	1
Howard	CITY	LOCATION	1
Howell	CITY	LOCATION	1
Hudson	CITY	LOCATION	1
Hull	CITY	LOCATION	1
Hurst	CITY	LOCATION	1
Hutchinson	CITY	LOCATION	1
Ibarra	CITY	LOCATION	1
Jackson	CITY	LOCATION	1
Jefferson	CITY	LOCATION	1
Jennings	CITY	LOCATION	1
Jimenez	CITY	LOCATION	1
Johnston	CITY	LOCATION	1
Jones	CITY	LOCATION	1
Jordan	CITY	LOCATION	1
Juarez	CITY	LOCATION	1
Keith	CITY	LOCATION	1
Keller	CITY	LOCATION	1
Kent	CITY	LOCATION	1
Kim	CITY	LOCATION	1
Kirby	CITY	LOCATION	1
Lara	CITY	LOCATION	1
Lawrence	CITY	LOCATION	1
Lee	CITY	LOCATION	1
Leon	CITY	LOCATION	1
Li	CITY	LOCATION	1
Livingston	CITY	LOCATION	1
Logan	CITY	LOCATION	1
Long	CITY	LOCATION	1
Lopez	CITY	LOCATION	1
Lucero	CITY	LOCATION	1
Luna	CITY	LOCATION	1
Lutz	CITY	LOCATION	1
Lynn	CITY	LOCATION	1
Lyons	CITY	LOCATION	1
Maldonado	CITY	LOCATION	1
Marks	CITY	LOCATION	1
Marshall	CITY	LOCATION	1
Martin	CITY	LOCATION	1
Martinez	CITY	LOCATION	1
Mason	CITY	LOCATION	1
Mata	CITY	LOCATION	1
Matthews	CITY	LOCATION	1
Maynard	CITY	LOCATION	1
Mayo	CITY	LOCATION	1
Medina	CITY	LOCATION	1
Melton	CITY	LOCATION	1
Mendez	CITY	LOCATION	1
Mendoza	CITY	LOCATION	1
Merritt	CITY	LOCATION	1
Middleton	CITY	LOCATION	1
Miranda	CITY	LOCATION	1
Mitchell	CITY	LOCATION	1
Molina	CITY	LOCATION	1
Monroe	CITY	LOCATION	1
Montgomery	CITY	LOCATION	1
Moore	CITY	LOCATION	1
Mora	CITY	LOCATION	1
Morales	CITY	LOCATION	1
Moreno	CITY	LOCATION	1
Morris	CITY	LOCATION	1
Morton	CITY	LOCATION	1
Munoz	CITY	LOCATION	1
Murillo	CITY	LOCATION	1
Murphy	CITY	LOCATION	1
Murray	CITY	LOCATION	1
Nelson	CITY	LOCATION	1
Newton	CITY	LOCATION	1
Norman	CITY	LOCATION	1
Norton	CITY	LOCATION	1
Oliver	CITY	LOCATION	1
Ortega	CITY	LOCATION	1
Padilla	CITY	LOCATION	1
Palmer	CITY	LOCATION	1
Parker	CITY	LOCATION	1
Parsons	CITY	LOCATION	1
Patterson	CITY	LOCATION	1
Pena	CITY	LOCATION	1
Perez	CITY	LOCATION	1
Perry	CITY	LOCATION	1
Phoenix	CITY	LOCATION	1
Poole	CITY	LOCATION	1
Powell	CITY	LOCATION	1
Preston	CITY	LOCATION	1
Price	CITY	LOCATION	1
Ramos	CITY	LOCATION	1
Ramsey	CITY	LOCATION	1
Randolph	CITY	LOCATION	1
Ray	CITY	LOCATION	1
Raymond	CITY	LOCATION	1
Reyes	CITY	LOCATION	1
Richardson	CITY	LOCATION	1
Richmond	CITY	LOCATION	1
Rivas	CITY	LOCATION	1
Rivera	CITY	LOCATION	1
Rivers	CITY	LOCATION	1
Robertson	CITY	LOCATION	1
Robinson	CITY	LOCATION	1
Rocha	CITY	LOCATION	1
Rogers	CITY	LOCATION	1
Roman	CITY	LOCATION	1
Rosario	CITY	LOCATION	1
Roth	CITY	LOCATION	1
Roy	CITY	LOCATION	1
Rubio	CITY	LOCATION	1
Ruiz	CITY	LOCATION	1
Rush	CITY	LOCATION	1
Russell	CITY	LOCATION	1
Salas	CITY	LOCATION	1
Salinas	CITY	LOCATION	1
Sanchez	CITY	LOCATION	1
Sanford	CITY	LOCATION	1
Santana	CITY	LOCATION	1
Santiago	CITY	LOCATION	1
Santos	CITY	LOCATION	1
Savage	CITY	LOCATION	1
Schroeder	CITY	LOCATION	1
Shannon	CITY	LOCATION	1
Shelton	CITY	LOCATION	1
Sherman	CITY	LOCATION	1
Singleton	CITY	LOCATION	1
Snyder	CITY	LOCATION	1
Sparks	CITY	LOCATION	1
Spencer	CITY	LOCATION	1
Stafford	CITY	LOCATION	1
Stanley	CITY	LOCATION	1
Stanton	CITY	LOCATION	1
Stein	CITY	LOCATION	1
Stuart	CITY	LOCATION	1
Suarez	CITY	LOCATION	1
Sutton	CITY	LOCATION	1
Tapia	CITY	LOCATION	1
Taylor	CITY	LOCATION	1
Terrell	CITY	LOCATION	1
Thompson	CITY	LOCATION	1
Thornton	CITY	LOCATION	1
Torres	CITY	LOCATION	1
Townsend	CITY	LOCATION	1
Tran	CITY	LOCATION	1
Trujillo	CITY	LOCATION	1
Tucker	CITY	LOCATION	1
Turner	CITY	LOCATION	1
Tyler	CITY	LOCATION	1
Valdez	CITY	LOCATION	1
Valencia	CITY	LOCATION	1
Valenzuela	CITY	LOCATION	1
Vargas	CITY	LOCATION	1
Velez	CITY	LOCATION	1
Villanueva	CITY	LOCATION	1
Walker	CITY	LOCATION	1
Ware	CITY	LOCATION	1
Warren	CITY	LOCATION	1
Webster	CITY	LOCATION	1
Wells	CITY	LOCATION	1
Wilson	CITY	LOCATION	1
Woodward	CITY	LOCATION	1
Wright	CITY	LOCATION	1
York	CITY	LOCATION	1
Young	CITY	LOCATION	1
Zamora	CITY	LOCATION	1
Rep\.?	TITLE	1
Speaker	TITLE	1
US-headquartered	COUNTRY	MISC	1
US-owned	COUNTRY	MISC	1
US-controlled	COUNTRY	MISC	1
US-raised	COUNTRY	MISC	1
US-educated	COUNTRY	MISC	1
US-backed	COUNTRY	MISC	1
US-trained	COUNTRY	MISC	1
US-born	COUNTRY	MISC	1
US-area	COUNTRY	MISC	1
US-registered	COUNTRY	MISC	1
AL-headquartered	STATE_OR_PROVINCE	MISC	1
AL-owned	STATE_OR_PROVINCE	MISC	1
AL-controlled	STATE_OR_PROVINCE	MISC	1
AL-raised	STATE_OR_PROVINCE	MISC	1
AL-educated	STATE_OR_PROVINCE	MISC	1
AL-backed	STATE_OR_PROVINCE	MISC	1
AL-trained	STATE_OR_PROVINCE	MISC	1
AL-born	STATE_OR_PROVINCE	MISC	1
AL-area	STATE_OR_PROVINCE	MISC	1
AL-registered	STATE_OR_PROVINCE	MISC	1
AK-headquartered	STATE_OR_PROVINCE	MISC	1
AK-owned	STATE_OR_PROVINCE	MISC	1
AK-controlled	STATE_OR_PROVINCE	MISC	1
AK-raised	STATE_OR_PROVINCE	MISC	1
AK-educated	STATE_OR_PROVINCE	MISC	1
AK-backed	STATE_OR_PROVINCE	MISC	1
AK-trained	STATE_OR_PROVINCE	MISC	1
AK-born	STATE_OR_PROVINCE	MISC	1
AK-area	STATE_OR_PROVINCE	MISC	1
AK-registered	STATE_OR_PROVINCE	MISC	1
AS-headquartered	STATE_OR_PROVINCE	MISC	1
AS-owned	STATE_OR_PROVINCE	MISC	1
AS-controlled	STATE_OR_PROVINCE	MISC	1
AS-raised	STATE_OR_PROVINCE	MISC	1
AS-educated	STATE_OR_PROVINCE	MISC	1
AS-backed	STATE_OR_PROVINCE	MISC	1
AS-trained	STATE_OR_PROVINCE	MISC	1
AS-born	STATE_OR_PROVINCE	MISC	1
AS-area	STATE_OR_PROVINCE	MISC	1
AS-registered	STATE_OR_PROVINCE	MISC	1
AZ-headquartered	STATE_OR_PROVINCE	MISC	1
AZ-owned	STATE_OR_PROVINCE	MISC	1
AZ-controlled	STATE_OR_PROVINCE	MISC	1
AZ-raised	STATE_OR_PROVINCE	MISC	1
AZ-educated	STATE_OR_PROVINCE	MISC	1
AZ-backed	STATE_OR_PROVINCE	MISC	1
AZ-trained	STATE_OR_PROVINCE	MISC	1
AZ-born	STATE_OR_PROVINCE	MISC	1
AZ-area	STATE_OR_PROVINCE	MISC	1
AZ-registered	STATE_OR_PROVINCE	MISC	1
AR-headquartered	STATE_OR_PROVINCE	MISC	1
AR-owned	STATE_OR_PROVINCE	MISC	1
AR-controlled	STATE_OR_PROVINCE	MISC	1
AR-raised	STATE_OR_PROVINCE	MISC	1
AR-educated	STATE_OR_PROVINCE	MISC	1
AR-backed	STATE_OR_PROVINCE	MISC	1
AR-trained	STATE_OR_PROVINCE	MISC	1
AR-born	STATE_OR_PROVINCE	MISC	1
AR-area	STATE_OR_PROVINCE	MISC	1
AR-registered	STATE_OR_PROVINCE	MISC	1
CA-headquartered	STATE_OR_PROVINCE	MISC	1
CA-owned	STATE_OR_PROVINCE	MISC	1
CA-controlled	STATE_OR_PROVINCE	MISC	1
CA-raised	STATE_OR_PROVINCE	MISC	1
CA-educated	STATE_OR_PROVINCE	MISC	1
CA-backed	STATE_OR_PROVINCE	MISC	1
CA-trained	STATE_OR_PROVINCE	MISC	1
CA-born	STATE_OR_PROVINCE	MISC	1
CA-area	STATE_OR_PROVINCE	MISC	1
CA-registered	STATE_OR_PROVINCE	MISC	1
CO-headquartered	STATE_OR_PROVINCE	MISC	1
CO-owned	STATE_OR_PROVINCE	MISC	1
CO-controlled	STATE_OR_PROVINCE	MISC	1
CO-raised	STATE_OR_PROVINCE	MISC	1
CO-educated	STATE_OR_PROVINCE	MISC	1
CO-backed	STATE_OR_PROVINCE	MISC	1
CO-trained	STATE_OR_PROVINCE	MISC	1
CO-born	STATE_OR_PROVINCE	MISC	1
CO-area	STATE_OR_PROVINCE	MISC	1
CO-registered	STATE_OR_PROVINCE	MISC	1
CT-headquartered	STATE_OR_PROVINCE	MISC	1
CT-owned	STATE_OR_PROVINCE	MISC	1
CT-controlled	STATE_OR_PROVINCE	MISC	1
CT-raised	STATE_OR_PROVINCE	MISC	1
CT-educated	STATE_OR_PROVINCE	MISC	1
CT-backed	STATE_OR_PROVINCE	MISC	1
CT-trained	STATE_OR_PROVINCE	MISC	1
CT-born	STATE_OR_PROVINCE	MISC	1
CT-area	STATE_OR_PROVINCE	MISC	1
CT-registered	STATE_OR_PROVINCE	MISC	1
DE-headquartered	STATE_OR_PROVINCE	MISC	1
DE-owned	STATE_OR_PROVINCE	MISC	1
DE-controlled	STATE_OR_PROVINCE	MISC	1
DE-raised	STATE_OR_PROVINCE	MISC	1
DE-educated	STATE_OR_PROVINCE	MISC	1
DE-backed	STATE_OR_PROVINCE	MISC	1
DE-trained	STATE_OR_PROVINCE	MISC	1
DE-born	STATE_OR_PROVINCE	MISC	1
DE-area	STATE_OR_PROVINCE	MISC	1
DE-registered	STATE_OR_PROVINCE	MISC	1
DC-headquartered	STATE_OR_PROVINCE	MISC	1
DC-owned	STATE_OR_PROVINCE	MISC	1
DC-controlled	STATE_OR_PROVINCE	MISC	1
DC-raised	STATE_OR_PROVINCE	MISC	1
DC-educated	STATE_OR_PROVINCE	MISC	1
DC-backed	STATE_OR_PROVINCE	MISC	1
DC-trained	STATE_OR_PROVINCE	MISC	1
DC-born	STATE_OR_PROVINCE	MISC	1
DC-area	STATE_OR_PROVINCE	MISC	1
DC-registered	STATE_OR_PROVINCE	MISC	1
FL-headquartered	STATE_OR_PROVINCE	MISC	1
FL-owned	STATE_OR_PROVINCE	MISC	1
FL-controlled	STATE_OR_PROVINCE	MISC	1
FL-raised	STATE_OR_PROVINCE	MISC	1
FL-educated	STATE_OR_PROVINCE	MISC	1
FL-backed	STATE_OR_PROVINCE	MISC	1
FL-trained	STATE_OR_PROVINCE	MISC	1
FL-born	STATE_OR_PROVINCE	MISC	1
FL-area	STATE_OR_PROVINCE	MISC	1
FL-registered	STATE_OR_PROVINCE	MISC	1
GA-headquartered	STATE_OR_PROVINCE	MISC	1
GA-owned	STATE_OR_PROVINCE	MISC	1
GA-controlled	STATE_OR_PROVINCE	MISC	1
GA-raised	STATE_OR_PROVINCE	MISC	1
GA-educated	STATE_OR_PROVINCE	MISC	1
GA-backed	STATE_OR_PROVINCE	MISC	1
GA-trained	STATE_OR_PROVINCE	MISC	1
GA-born	STATE_OR_PROVINCE	MISC	1
GA-area	STATE_OR_PROVINCE	MISC	1
GA-registered	STATE_OR_PROVINCE	MISC	1
GU-headquartered	STATE_OR_PROVINCE	MISC	1
GU-owned	STATE_OR_PROVINCE	MISC	1
GU-controlled	STATE_OR_PROVINCE	MISC	1
GU-raised	STATE_OR_PROVINCE	MISC	1
GU-educated	STATE_OR_PROVINCE	MISC	1
GU-backed	STATE_OR_PROVINCE	MISC	1
GU-trained	STATE_OR_PROVINCE	MISC	1
GU-born	STATE_OR_PROVINCE	MISC	1
GU-area	STATE_OR_PROVINCE	MISC	1
GU-registered	STATE_OR_PROVINCE	MISC	1
HI-headquartered	STATE_OR_PROVINCE	MISC	1
HI-owned	STATE_OR_PROVINCE	MISC	1
HI-controlled	STATE_OR_PROVINCE	MISC	1
HI-raised	STATE_OR_PROVINCE	MISC	1
HI-educated	STATE_OR_PROVINCE	MISC	1
HI-backed	STATE_OR_PROVINCE	MISC	1
HI-trained	STATE_OR_PROVINCE	MISC	1
HI-born	STATE_OR_PROVINCE	MISC	1
HI-area	STATE_OR_PROVINCE	MISC	1
HI-registered	STATE_OR_PROVINCE	MISC	1
ID-headquartered	STATE_OR_PROVINCE	MISC	1
ID-owned	STATE_OR_PROVINCE	MISC	1
ID-controlled	STATE_OR_PROVINCE	MISC	1
ID-raised	STATE_OR_PROVINCE	MISC	1
ID-educated	STATE_OR_PROVINCE	MISC	1
ID-backed	STATE_OR_PROVINCE	MISC	1
ID-trained	STATE_OR_PROVINCE	MISC	1
ID-born	STATE_OR_PROVINCE	MISC	1
ID-area	STATE_OR_PROVINCE	MISC	1
ID-registered	STATE_OR_PROVINCE	MISC	1
IL-headquartered	STATE_OR_PROVINCE	MISC	1
IL-owned	STATE_OR_PROVINCE	MISC	1
IL-controlled	STATE_OR_PROVINCE	MISC	1
IL-raised	STATE_OR_PROVINCE	MISC	1
IL-educated	STATE_OR_PROVINCE	MISC	1
IL-backed	STATE_OR_PROVINCE	MISC	1
IL-trained	STATE_OR_PROVINCE	MISC	1
IL-born	STATE_OR_PROVINCE	MISC	1
IL-area	STATE_OR_PROVINCE	MISC	1
IL-registered	STATE_OR_PROVINCE	MISC	1
IN-headquartered	STATE_OR_PROVINCE	MISC	1
IN-owned	STATE_OR_PROVINCE	MISC	1
IN-controlled	STATE_OR_PROVINCE	MISC	1
IN-raised	STATE_OR_PROVINCE	MISC	1
IN-educated	STATE_OR_PROVINCE	MISC	1
IN-backed	STATE_OR_PROVINCE	MISC	1
IN-trained	STATE_OR_PROVINCE	MISC	1
IN-born	STATE_OR_PROVINCE	MISC	1
IN-area	STATE_OR_PROVINCE	MISC	1
IN-registered	STATE_OR_PROVINCE	MISC	1
IA-headquartered	STATE_OR_PROVINCE	MISC	1
IA-owned	STATE_OR_PROVINCE	MISC	1
IA-controlled	STATE_OR_PROVINCE	MISC	1
IA-raised	STATE_OR_PROVINCE	MISC	1
IA-educated	STATE_OR_PROVINCE	MISC	1
IA-backed	STATE_OR_PROVINCE	MISC	1
IA-trained	STATE_OR_PROVINCE	MISC	1
IA-born	STATE_OR_PROVINCE	MISC	1
IA-area	STATE_OR_PROVINCE	MISC	1
IA-registered	STATE_OR_PROVINCE	MISC	1
KS-headquartered	STATE_OR_PROVINCE	MISC	1
KS-owned	STATE_OR_PROVINCE	MISC	1
KS-controlled	STATE_OR_PROVINCE	MISC	1
KS-raised	STATE_OR_PROVINCE	MISC	1
KS-educated	STATE_OR_PROVINCE	MISC	1
KS-backed	STATE_OR_PROVINCE	MISC	1
KS-trained	STATE_OR_PROVINCE	MISC	1
KS-born	STATE_OR_PROVINCE	MISC	1
KS-area	STATE_OR_PROVINCE	MISC	1
KS-registered	STATE_OR_PROVINCE	MISC	1
KY-headquartered	STATE_OR_PROVINCE	MISC	1
KY-owned	STATE_OR_PROVINCE	MISC	1
KY-controlled	STATE_OR_PROVINCE	MISC	1
KY-raised	STATE_OR_PROVINCE	MISC	1
KY-educated	STATE_OR_PROVINCE	MISC	1
KY-backed	STATE_OR_PROVINCE	MISC	1
KY-trained	STATE_OR_PROVINCE	MISC	1
KY-born	STATE_OR_PROVINCE	MISC	1
KY-area	STATE_OR_PROVINCE	MISC	1
KY-registered	STATE_OR_PROVINCE	MISC	1
LA-headquartered	STATE_OR_PROVINCE	MISC	1
LA-owned	STATE_OR_PROVINCE	MISC	1
LA-controlled	STATE_OR_PROVINCE	MISC	1
LA-raised	STATE_OR_PROVINCE	MISC	1
LA-educated	STATE_OR_PROVINCE	MISC	1
LA-backed	STATE_OR_PROVINCE	MISC	1
LA-trained	STATE_OR_PROVINCE	MISC	1
LA-born	STATE_OR_PROVINCE	MISC	1
LA-area	STATE_OR_PROVINCE	MISC	1
LA-registered	STATE_OR_PROVINCE	MISC	1
ME-headquartered	STATE_OR_PROVINCE	MISC	1
ME-owned	STATE_OR_PROVINCE	MISC	1
ME-controlled	STATE_OR_PROVINCE	MISC	1
ME-raised	STATE_OR_PROVINCE	MISC	1
ME-educated	STATE_OR_PROVINCE	MISC	1
ME-backed	STATE_OR_PROVINCE	MISC	1
ME-trained	STATE_OR_PROVINCE	MISC	1
ME-born	STATE_OR_PROVINCE	MISC	1
ME-area	STATE_OR_PROVINCE	MISC	1
ME-registered	STATE_OR_PROVINCE	MISC	1
MD-headquartered	STATE_OR_PROVINCE	MISC	1
MD-owned	STATE_OR_PROVINCE	MISC	1
MD-controlled	STATE_OR_PROVINCE	MISC	1
MD-raised	STATE_OR_PROVINCE	MISC	1
MD-educated	STATE_OR_PROVINCE	MISC	1
MD-backed	STATE_OR_PROVINCE	MISC	1
MD-trained	STATE_OR_PROVINCE	MISC	1
MD-born	STATE_OR_PROVINCE	MISC	1
MD-area	STATE_OR_PROVINCE	MISC	1
MD-registered	STATE_OR_PROVINCE	MISC	1
MA-headquartered	STATE_OR_PROVINCE	MISC	1
MA-owned	STATE_OR_PROVINCE	MISC	1
MA-controlled	STATE_OR_PROVINCE	MISC	1
MA-raised	STATE_OR_PROVINCE	MISC	1
MA-educated	STATE_OR_PROVINCE	MISC	1
MA-backed	STATE_OR_PROVINCE	MISC	1
MA-trained	STATE_OR_PROVINCE	MISC	1
MA-born	STATE_OR_PROVINCE	MISC	1
MA-area	STATE_OR_PROVINCE	MISC	1
MA-registered	STATE_OR_PROVINCE	MISC	1
MI-headquartered	STATE_OR_PROVINCE	MISC	1
MI-owned	STATE_OR_PROVINCE	MISC	1
MI-controlled	STATE_OR_PROVINCE	MISC	1
MI-raised	STATE_OR_PROVINCE	MISC	1
MI-educated	STATE_OR_PROVINCE	MISC	1
MI-backed	STATE_OR_PROVINCE	MISC	1
MI-trained	STATE_OR_PROVINCE	MISC	1
MI-born	STATE_OR_PROVINCE	MISC	1
MI-area	STATE_OR_PROVINCE	MISC	1
MI-registered	STATE_OR_PROVINCE	MISC	1
MN-headquartered	STATE_OR_PROVINCE	MISC	1
MN-owned	STATE_OR_PROVINCE	MISC	1
MN-controlled	STATE_OR_PROVINCE	MISC	1
MN-raised	STATE_OR_PROVINCE	MISC	1
MN-educated	STATE_OR_PROVINCE	MISC	1
MN-backed	STATE_OR_PROVINCE	MISC	1
MN-trained	STATE_OR_PROVINCE	MISC	1
MN-born	STATE_OR_PROVINCE	MISC	1
MN-area	STATE_OR_PROVINCE	MISC	1
MN-registered	STATE_OR_PROVINCE	MISC	1
MS-headquartered	STATE_OR_PROVINCE	MISC	1
MS-owned	STATE_OR_PROVINCE	MISC	1
MS-controlled	STATE_OR_PROVINCE	MISC	1
MS-raised	STATE_OR_PROVINCE	MISC	1
MS-educated	STATE_OR_PROVINCE	MISC	1
MS-backed	STATE_OR_PROVINCE	MISC	1
MS-trained	STATE_OR_PROVINCE	MISC	1
MS-born	STATE_OR_PROVINCE	MISC	1
MS-area	STATE_OR_PROVINCE	MISC	1
MS-registered	STATE_OR_PROVINCE	MISC	1
MO-headquartered	STATE_OR_PROVINCE	MISC	1
MO-owned	STATE_OR_PROVINCE	MISC	1
MO-controlled	STATE_OR_PROVINCE	MISC	1
MO-raised	STATE_OR_PROVINCE	MISC	1
MO-educated	STATE_OR_PROVINCE	MISC	1
MO-backed	STATE_OR_PROVINCE	MISC	1
MO-trained	STATE_OR_PROVINCE	MISC	1
MO-born	STATE_OR_PROVINCE	MISC	1
MO-area	STATE_OR_PROVINCE	MISC	1
MO-registered	STATE_OR_PROVINCE	MISC	1
MT-headquartered	STATE_OR_PROVINCE	MISC	1
MT-owned	STATE_OR_PROVINCE	MISC	1
MT-controlled	STATE_OR_PROVINCE	MISC	1
MT-raised	STATE_OR_PROVINCE	MISC	1
MT-educated	STATE_OR_PROVINCE	MISC	1
MT-backed	STATE_OR_PROVINCE	MISC	1
MT-trained	STATE_OR_PROVINCE	MISC	1
MT-born	STATE_OR_PROVINCE	MISC	1
MT-area	STATE_OR_PROVINCE	MISC	1
MT-registered	STATE_OR_PROVINCE	MISC	1
NE-headquartered	STATE_OR_PROVINCE	MISC	1
NE-owned	STATE_OR_PROVINCE	MISC	1
NE-controlled	STATE_OR_PROVINCE	MISC	1
NE-raised	STATE_OR_PROVINCE	MISC	1
NE-educated	STATE_OR_PROVINCE	MISC	1
NE-backed	STATE_OR_PROVINCE	MISC	1
NE-trained	STATE_OR_PROVINCE	MISC	1
NE-born	STATE_OR_PROVINCE	MISC	1
NE-area	STATE_OR_PROVINCE	MISC	1
NE-registered	STATE_OR_PROVINCE	MISC	1
NV-headquartered	STATE_OR_PROVINCE	MISC	1
NV-owned	STATE_OR_PROVINCE	MISC	1
NV-controlled	STATE_OR_PROVINCE	MISC	1
NV-raised	STATE_OR_PROVINCE	MISC	1
NV-educated	STATE_OR_PROVINCE	MISC	1
NV-backed	STATE_OR_PROVINCE	MISC	1
NV-trained	STATE_OR_PROVINCE	MISC	1
NV-born	STATE_OR_PROVINCE	MISC	1
NV-area	STATE_OR_PROVINCE	MISC	1
NV-registered	STATE_OR_PROVINCE	MISC	1
NH-headquartered	STATE_OR_PROVINCE	MISC	1
NH-owned	STATE_OR_PROVINCE	MISC	1
NH-controlled	STATE_OR_PROVINCE	MISC	1
NH-raised	STATE_OR_PROVINCE	MISC	1
NH-educated	STATE_OR_PROVINCE	MISC	1
NH-backed	STATE_OR_PROVINCE	MISC	1
NH-trained	STATE_OR_PROVINCE	MISC	1
NH-born	STATE_OR_PROVINCE	MISC	1
NH-area	STATE_OR_PROVINCE	MISC	1
NH-registered	STATE_OR_PROVINCE	MISC	1
NJ-headquartered	STATE_OR_PROVINCE	MISC	1
NJ-owned	STATE_OR_PROVINCE	MISC	1
NJ-controlled	STATE_OR_PROVINCE	MISC	1
NJ-raised	STATE_OR_PROVINCE	MISC	1
NJ-educated	STATE_OR_PROVINCE	MISC	1
NJ-backed	STATE_OR_PROVINCE	MISC	1
NJ-trained	STATE_OR_PROVINCE	MISC	1
NJ-born	STATE_OR_PROVINCE	MISC	1
NJ-area	STATE_OR_PROVINCE	MISC	1
NJ-registered	STATE_OR_PROVINCE	MISC	1
NM-headquartered	STATE_OR_PROVINCE	MISC	1
NM-owned	STATE_OR_PROVINCE	MISC	1
NM-controlled	STATE_OR_PROVINCE	MISC	1
NM-raised	STATE_OR_PROVINCE	MISC	1
NM-educated	STATE_OR_PROVINCE	MISC	1
NM-backed	STATE_OR_PROVINCE	MISC	1
NM-trained	STATE_OR_PROVINCE	MISC	1
NM-born	STATE_OR_PROVINCE	MISC	1
NM-area	STATE_OR_PROVINCE	MISC	1
NM-registered	STATE_OR_PROVINCE	MISC	1
NY-headquartered	STATE_OR_PROVINCE	MISC	1
NY-owned	STATE_OR_PROVINCE	MISC	1
NY-controlled	STATE_OR_PROVINCE	MISC	1
NY-raised	STATE_OR_PROVINCE	MISC	1
NY-educated	STATE_OR_PROVINCE	MISC	1
NY-backed	STATE_OR_PROVINCE	MISC	1
NY-trained	STATE_OR_PROVINCE	MISC	1
NY-born	STATE_OR_PROVINCE	MISC	1
NY-area	STATE_OR_PROVINCE	MISC	1
NY-registered	STATE_OR_PROVINCE	MISC	1
NC-headquartered	STATE_OR_PROVINCE	MISC	1
NC-owned	STATE_OR_PROVINCE	MISC	1
NC-controlled	STATE_OR_PROVINCE	MISC	1
NC-raised	STATE_OR_PROVINCE	MISC	1
NC-educated	STATE_OR_PROVINCE	MISC	1
NC-backed	STATE_OR_PROVINCE	MISC	1
NC-trained	STATE_OR_PROVINCE	MISC	1
NC-born	STATE_OR_PROVINCE	MISC	1
NC-area	STATE_OR_PROVINCE	MISC	1
NC-registered	STATE_OR_PROVINCE	MISC	1
ND-headquartered	STATE_OR_PROVINCE	MISC	1
ND-owned	STATE_OR_PROVINCE	MISC	1
ND-controlled	STATE_OR_PROVINCE	MISC	1
ND-raised	STATE_OR_PROVINCE	MISC	1
ND-educated	STATE_OR_PROVINCE	MISC	1
ND-backed	STATE_OR_PROVINCE	MISC	1
ND-trained	STATE_OR_PROVINCE	MISC	1
ND-born	STATE_OR_PROVINCE	MISC	1
ND-area	STATE_OR_PROVINCE	MISC	1
ND-registered	STATE_OR_PROVINCE	MISC	1
OH-headquartered	STATE_OR_PROVINCE	MISC	1
OH-owned	STATE_OR_PROVINCE	MISC	1
OH-controlled	STATE_OR_PROVINCE	MISC	1
OH-raised	STATE_OR_PROVINCE	MISC	1
OH-educated	STATE_OR_PROVINCE	MISC	1
OH-backed	STATE_OR_PROVINCE	MISC	1
OH-trained	STATE_OR_PROVINCE	MISC	1
OH-born	STATE_OR_PROVINCE	MISC	1
OH-area	STATE_OR_PROVINCE	MISC	1
OH-registered	STATE_OR_PROVINCE	MISC	1
OK-headquartered	STATE_OR_PROVINCE	MISC	1
OK-owned	STATE_OR_PROVINCE	MISC	1
OK-controlled	STATE_OR_PROVINCE	MISC	1
OK-raised	STATE_OR_PROVINCE	MISC	1
OK-educated	STATE_OR_PROVINCE	MISC	1
OK-backed	STATE_OR_PROVINCE	MISC	1
OK-trained	STATE_OR_PROVINCE	MISC	1
OK-born	STATE_OR_PROVINCE	MISC	1
OK-area	STATE_OR_PROVINCE	MISC	1
OK-registered	STATE_OR_PROVINCE	MISC	1
OR-headquartered	STATE_OR_PROVINCE	MISC	1
OR-owned	STATE_OR_PROVINCE	MISC	1
OR-controlled	STATE_OR_PROVINCE	MISC	1
OR-raised	STATE_OR_PROVINCE	MISC	1
OR-educated	STATE_OR_PROVINCE	MISC	1
OR-backed	STATE_OR_PROVINCE	MISC	1
OR-trained	STATE_OR_PROVINCE	MISC	1
OR-born	STATE_OR_PROVINCE	MISC	1
OR-area	STATE_OR_PROVINCE	MISC	1
OR-registered	STATE_OR_PROVINCE	MISC	1
PA-headquartered	STATE_OR_PROVINCE	MISC	1
PA-owned	STATE_OR_PROVINCE	MISC	1
PA-controlled	STATE_OR_PROVINCE	MISC	1
PA-raised	STATE_OR_PROVINCE	MISC	1
PA-educated	STATE_OR_PROVINCE	MISC	1
PA-backed	STATE_OR_PROVINCE	MISC	1
PA-trained	STATE_OR_PROVINCE	MISC	1
PA-born	STATE_OR_PROVINCE	MISC	1
PA-area	STATE_OR_PROVINCE	MISC	1
PA-registered	STATE_OR_PROVINCE	MISC	1
PR-headquartered	STATE_OR_PROVINCE	MISC	1
PR-owned	STATE_OR_PROVINCE	MISC	1
PR-controlled	STATE_OR_PROVINCE	MISC	1
PR-raised	STATE_OR_PROVINCE	MISC	1
PR-educated	STATE_OR_PROVINCE	MISC	1
PR-backed	STATE_OR_PROVINCE	MISC	1
PR-trained	STATE_OR_PROVINCE	MISC	1
PR-born	STATE_OR_PROVINCE	MISC	1
PR-area	STATE_OR_PROVINCE	MISC	1
PR-registered	STATE_OR_PROVINCE	MISC	1
RI-headquartered	STATE_OR_PROVINCE	MISC	1
RI-owned	STATE_OR_PROVINCE	MISC	1
RI-controlled	STATE_OR_PROVINCE	MISC	1
RI-raised	STATE_OR_PROVINCE	MISC	1
RI-educated	STATE_OR_PROVINCE	MISC	1
RI-backed	STATE_OR_PROVINCE	MISC	1
RI-trained	STATE_OR_PROVINCE	MISC	1
RI-born	STATE_OR_PROVINCE	MISC	1
RI-area	STATE_OR_PROVINCE	MISC	1
RI-registered	STATE_OR_PROVINCE	MISC	1
SC-headquartered	STATE_OR_PROVINCE	MISC	1
SC-owned	STATE_OR_PROVINCE	MISC	1
SC-controlled	STATE_OR_PROVINCE	MISC	1
SC-raised	STATE_OR_PROVINCE	MISC	1
SC-educated	STATE_OR_PROVINCE	MISC	1
SC-backed	STATE_OR_PROVINCE	MISC	1
SC-trained	STATE_OR_PROVINCE	MISC	1
SC-born	STATE_OR_PROVINCE	MISC	1
SC-area	STATE_OR_PROVINCE	MISC	1
SC-registered	STATE_OR_PROVINCE	MISC	1
SD-headquartered	STATE_OR_PROVINCE	MISC	1
SD-owned	STATE_OR_PROVINCE	MISC	1
SD-controlled	STATE_OR_PROVINCE	MISC	1
SD-raised	STATE_OR_PROVINCE	MISC	1
SD-educated	STATE_OR_PROVINCE	MISC	1
SD-backed	STATE_OR_PROVINCE	MISC	1
SD-trained	STATE_OR_PROVINCE	MISC	1
SD-born	STATE_OR_PROVINCE	MISC	1
SD-area	STATE_OR_PROVINCE	MISC	1
SD-registered	STATE_OR_PROVINCE	MISC	1
TN-headquartered	STATE_OR_PROVINCE	MISC	1
TN-owned	STATE_OR_PROVINCE	MISC	1
TN-controlled	STATE_OR_PROVINCE	MISC	1
TN-raised	STATE_OR_PROVINCE	MISC	1
TN-educated	STATE_OR_PROVINCE	MISC	1
TN-backed	STATE_OR_PROVINCE	MISC	1
TN-trained	STATE_OR_PROVINCE	MISC	1
TN-born	STATE_OR_PROVINCE	MISC	1
TN-area	STATE_OR_PROVINCE	MISC	1
TN-registered	STATE_OR_PROVINCE	MISC	1
TX-headquartered	STATE_OR_PROVINCE	MISC	1
TX-owned	STATE_OR_PROVINCE	MISC	1
TX-controlled	STATE_OR_PROVINCE	MISC	1
TX-raised	STATE_OR_PROVINCE	MISC	1
TX-educated	STATE_OR_PROVINCE	MISC	1
TX-backed	STATE_OR_PROVINCE	MISC	1
TX-trained	STATE_OR_PROVINCE	MISC	1
TX-born	STATE_OR_PROVINCE	MISC	1
TX-area	STATE_OR_PROVINCE	MISC	1
TX-registered	STATE_OR_PROVINCE	MISC	1
UT-headquartered	STATE_OR_PROVINCE	MISC	1
UT-owned	STATE_OR_PROVINCE	MISC	1
UT-controlled	STATE_OR_PROVINCE	MISC	1
UT-raised	STATE_OR_PROVINCE	MISC	1
UT-educated	STATE_OR_PROVINCE	MISC	1
UT-backed	STATE_OR_PROVINCE	MISC	1
UT-trained	STATE_OR_PROVINCE	MISC	1
UT-born	STATE_OR_PROVINCE	MISC	1
UT-area	STATE_OR_PROVINCE	MISC	1
UT-registered	STATE_OR_PROVINCE	MISC	1
VT-headquartered	STATE_OR_PROVINCE	MISC	1
VT-owned	STATE_OR_PROVINCE	MISC	1
VT-controlled	STATE_OR_PROVINCE	MISC	1
VT-raised	STATE_OR_PROVINCE	MISC	1
VT-educated	STATE_OR_PROVINCE	MISC	1
VT-backed	STATE_OR_PROVINCE	MISC	1
VT-trained	STATE_OR_PROVINCE	MISC	1
VT-born	STATE_OR_PROVINCE	MISC	1
VT-area	STATE_OR_PROVINCE	MISC	1
VT-registered	STATE_OR_PROVINCE	MISC	1
VI-headquartered	STATE_OR_PROVINCE	MISC	1
VI-owned	STATE_OR_PROVINCE	MISC	1
VI-controlled	STATE_OR_PROVINCE	MISC	1
VI-raised	STATE_OR_PROVINCE	MISC	1
VI-educated	STATE_OR_PROVINCE	MISC	1
VI-backed	STATE_OR_PROVINCE	MISC	1
VI-trained	STATE_OR_PROVINCE	MISC	1
VI-born	STATE_OR_PROVINCE	MISC	1
VI-area	STATE_OR_PROVINCE	MISC	1
VI-registered	STATE_OR_PROVINCE	MISC	1
VA-headquartered	STATE_OR_PROVINCE	MISC	1
VA-owned	STATE_OR_PROVINCE	MISC	1
VA-controlled	STATE_OR_PROVINCE	MISC	1
VA-raised	STATE_OR_PROVINCE	MISC	1
VA-educated	STATE_OR_PROVINCE	MISC	1
VA-backed	STATE_OR_PROVINCE	MISC	1
VA-trained	STATE_OR_PROVINCE	MISC	1
VA-born	STATE_OR_PROVINCE	MISC	1
VA-area	STATE_OR_PROVINCE	MISC	1
VA-registered	STATE_OR_PROVINCE	MISC	1
WA-headquartered	STATE_OR_PROVINCE	MISC	1
WA-owned	STATE_OR_PROVINCE	MISC	1
WA-controlled	STATE_OR_PROVINCE	MISC	1
WA-raised	STATE_OR_PROVINCE	MISC	1
WA-educated	STATE_OR_PROVINCE	MISC	1
WA-backed	STATE_OR_PROVINCE	MISC	1
WA-trained	STATE_OR_PROVINCE	MISC	1
WA-born	STATE_OR_PROVINCE	MISC	1
WA-area	STATE_OR_PROVINCE	MISC	1
WA-registered	STATE_OR_PROVINCE	MISC	1
WV-headquartered	STATE_OR_PROVINCE	MISC	1
WV-owned	STATE_OR_PROVINCE	MISC	1
WV-controlled	STATE_OR_PROVINCE	MISC	1
WV-raised	STATE_OR_PROVINCE	MISC	1
WV-educated	STATE_OR_PROVINCE	MISC	1
WV-backed	STATE_OR_PROVINCE	MISC	1
WV-trained	STATE_OR_PROVINCE	MISC	1
WV-born	STATE_OR_PROVINCE	MISC	1
WV-area	STATE_OR_PROVINCE	MISC	1
WV-registered	STATE_OR_PROVINCE	MISC	1
WI-headquartered	STATE_OR_PROVINCE	MISC	1
WI-owned	STATE_OR_PROVINCE	MISC	1
WI-controlled	STATE_OR_PROVINCE	MISC	1
WI-raised	STATE_OR_PROVINCE	MISC	1
WI-educated	STATE_OR_PROVINCE	MISC	1
WI-backed	STATE_OR_PROVINCE	MISC	1
WI-trained	STATE_OR_PROVINCE	MISC	1
WI-born	STATE_OR_PROVINCE	MISC	1
WI-area	STATE_OR_PROVINCE	MISC	1
WI-registered	STATE_OR_PROVINCE	MISC	1
WY-headquartered	STATE_OR_PROVINCE	MISC	1
WY-owned	STATE_OR_PROVINCE	MISC	1
WY-controlled	STATE_OR_PROVINCE	MISC	1
WY-raised	STATE_OR_PROVINCE	MISC	1
WY-educated	STATE_OR_PROVINCE	MISC	1
WY-backed	STATE_OR_PROVINCE	MISC	1
WY-trained	STATE_OR_PROVINCE	MISC	1
WY-born	STATE_OR_PROVINCE	MISC	1
WY-area	STATE_OR_PROVINCE	MISC	1
WY-registered	STATE_OR_PROVINCE	MISC	1
AB-headquartered	STATE_OR_PROVINCE	MISC	1
AB-owned	STATE_OR_PROVINCE	MISC	1
AB-controlled	STATE_OR_PROVINCE	MISC	1
AB-raised	STATE_OR_PROVINCE	MISC	1
AB-educated	STATE_OR_PROVINCE	MISC	1
AB-backed	STATE_OR_PROVINCE	MISC	1
AB-trained	STATE_OR_PROVINCE	MISC	1
AB-born	STATE_OR_PROVINCE	MISC	1
AB-area	STATE_OR_PROVINCE	MISC	1
AB-registered	STATE_OR_PROVINCE	MISC	1
BC-headquartered	STATE_OR_PROVINCE	MISC	1
BC-owned	STATE_OR_PROVINCE	MISC	1
BC-controlled	STATE_OR_PROVINCE	MISC	1
BC-raised	STATE_OR_PROVINCE	MISC	1
BC-educated	STATE_OR_PROVINCE	MISC	1
BC-backed	STATE_OR_PROVINCE	MISC	1
BC-trained	STATE_OR_PROVINCE	MISC	1
BC-born	STATE_OR_PROVINCE	MISC	1
BC-area	STATE_OR_PROVINCE	MISC	1
BC-registered	STATE_OR_PROVINCE	MISC	1
MB-headquartered	STATE_OR_PROVINCE	MISC	1
MB-owned	STATE_OR_PROVINCE	MISC	1
MB-controlled	STATE_OR_PROVINCE	MISC	1
MB-raised	STATE_OR_PROVINCE	MISC	1
MB-educated	STATE_OR_PROVINCE	MISC	1
MB-backed	STATE_OR_PROVINCE	MISC	1
MB-trained	STATE_OR_PROVINCE	MISC	1
MB-born	STATE_OR_PROVINCE	MISC	1
MB-area	STATE_OR_PROVINCE	MISC	1
MB-registered	STATE_OR_PROVINCE	MISC	1
NB-headquartered	STATE_OR_PROVINCE	MISC	1
NB-owned	STATE_OR_PROVINCE	MISC	1
NB-controlled	STATE_OR_PROVINCE	MISC	1
NB-raised	STATE_OR_PROVINCE	MISC	1
NB-educated	STATE_OR_PROVINCE	MISC	1
NB-backed	STATE_OR_PROVINCE	MISC	1
NB-trained	STATE_OR_PROVINCE	MISC	1
NB-born	STATE_OR_PROVINCE	MISC	1
NB-area	STATE_OR_PROVINCE	MISC	1
NB-registered	STATE_OR_PROVINCE	MISC	1
NL-headquartered	STATE_OR_PROVINCE	MISC	1
NL-owned	STATE_OR_PROVINCE	MISC	1
NL-controlled	STATE_OR_PROVINCE	MISC	1
NL-raised	STATE_OR_PROVINCE	MISC	1
NL-educated	STATE_OR_PROVINCE	MISC	1
NL-backed	STATE_OR_PROVINCE	MISC	1
NL-trained	STATE_OR_PROVINCE	MISC	1
NL-born	STATE_OR_PROVINCE	MISC	1
NL-area	STATE_OR_PROVINCE	MISC	1
NL-registered	STATE_OR_PROVINCE	MISC	1
NT-headquartered	STATE_OR_PROVINCE	MISC	1
NT-owned	STATE_OR_PROVINCE	MISC	1
NT-controlled	STATE_OR_PROVINCE	MISC	1
NT-raised	STATE_OR_PROVINCE	MISC	1
NT-educated	STATE_OR_PROVINCE	MISC	1
NT-backed	STATE_OR_PROVINCE	MISC	1
NT-trained	STATE_OR_PROVINCE	MISC	1
NT-born	STATE_OR_PROVINCE	MISC	1
NT-area	STATE_OR_PROVINCE	MISC	1
NT-registered	STATE_OR_PROVINCE	MISC	1
NS-headquartered	STATE_OR_PROVINCE	MISC	1
NS-owned	STATE_OR_PROVINCE	MISC	1
NS-controlled	STATE_OR_PROVINCE	MISC	1
NS-raised	STATE_OR_PROVINCE	MISC	1
NS-educated	STATE_OR_PROVINCE	MISC	1
NS-backed	STATE_OR_PROVINCE	MISC	1
NS-trained	STATE_OR_PROVINCE	MISC	1
NS-born	STATE_OR_PROVINCE	MISC	1
NS-area	STATE_OR_PROVINCE	MISC	1
NS-registered	STATE_OR_PROVINCE	MISC	1
NU-headquartered	STATE_OR_PROVINCE	MISC	1
NU-owned	STATE_OR_PROVINCE	MISC	1
NU-controlled	STATE_OR_PROVINCE	MISC	1
NU-raised	STATE_OR_PROVINCE	MISC	1
NU-educated	STATE_OR_PROVINCE	MISC	1
NU-backed	STATE_OR_PROVINCE	MISC	1
NU-trained	STATE_OR_PROVINCE	MISC	1
NU-born	STATE_OR_PROVINCE	MISC	1
NU-area	STATE_OR_PROVINCE	MISC	1
NU-registered	STATE_OR_PROVINCE	MISC	1
ON-headquartered	STATE_OR_PROVINCE	MISC	1
ON-owned	STATE_OR_PROVINCE	MISC	1
ON-controlled	STATE_OR_PROVINCE	MISC	1
ON-raised	STATE_OR_PROVINCE	MISC	1
ON-educated	STATE_OR_PROVINCE	MISC	1
ON-backed	STATE_OR_PROVINCE	MISC	1
ON-trained	STATE_OR_PROVINCE	MISC	1
ON-born	STATE_OR_PROVINCE	MISC	1
ON-area	STATE_OR_PROVINCE	MISC	1
ON-registered	STATE_OR_PROVINCE	MISC	1
PE-headquartered	STATE_OR_PROVINCE	MISC	1
PE-owned	STATE_OR_PROVINCE	MISC	1
PE-controlled	STATE_OR_PROVINCE	MISC	1
PE-raised	STATE_OR_PROVINCE	MISC	1
PE-educated	STATE_OR_PROVINCE	MISC	1
PE-backed	STATE_OR_PROVINCE	MISC	1
PE-trained	STATE_OR_PROVINCE	MISC	1
PE-born	STATE_OR_PROVINCE	MISC	1
PE-area	STATE_OR_PROVINCE	MISC	1
PE-registered	STATE_OR_PROVINCE	MISC	1
QC-headquartered	STATE_OR_PROVINCE	MISC	1
QC-owned	STATE_OR_PROVINCE	MISC	1
QC-controlled	STATE_OR_PROVINCE	MISC	1
QC-raised	STATE_OR_PROVINCE	MISC	1
QC-educated	STATE_OR_PROVINCE	MISC	1
QC-backed	STATE_OR_PROVINCE	MISC	1
QC-trained	STATE_OR_PROVINCE	MISC	1
QC-born	STATE_OR_PROVINCE	MISC	1
QC-area	STATE_OR_PROVINCE	MISC	1
QC-registered	STATE_OR_PROVINCE	MISC	1
SK-headquartered	STATE_OR_PROVINCE	MISC	1
SK-owned	STATE_OR_PROVINCE	MISC	1
SK-controlled	STATE_OR_PROVINCE	MISC	1
SK-raised	STATE_OR_PROVINCE	MISC	1
SK-educated	STATE_OR_PROVINCE	MISC	1
SK-backed	STATE_OR_PROVINCE	MISC	1
SK-trained	STATE_OR_PROVINCE	MISC	1
SK-born	STATE_OR_PROVINCE	MISC	1
SK-area	STATE_OR_PROVINCE	MISC	1
SK-registered	STATE_OR_PROVINCE	MISC	1
YT-headquartered	STATE_OR_PROVINCE	MISC	1
YT-owned	STATE_OR_PROVINCE	MISC	1
YT-controlled	STATE_OR_PROVINCE	MISC	1
YT-raised	STATE_OR_PROVINCE	MISC	1
YT-educated	STATE_OR_PROVINCE	MISC	1
YT-backed	STATE_OR_PROVINCE	MISC	1
YT-trained	STATE_OR_PROVINCE	MISC	1
YT-born	STATE_OR_PROVINCE	MISC	1
YT-area	STATE_OR_PROVINCE	MISC	1
YT-registered	STATE_OR_PROVINCE	MISC	1
Ala\.?-headquartered	STATE_OR_PROVINCE	MISC	1
Ala\.?-owned	STATE_OR_PROVINCE	MISC	1
Ala\.?-controlled	STATE_OR_PROVINCE	MISC	1
Ala\.?-raised	STATE_OR_PROVINCE	MISC	1
Ala\.?-educated	STATE_OR_PROVINCE	MISC	1
Ala\.?-backed	STATE_OR_PROVINCE	MISC	1
Ala\.?-trained	STATE_OR_PROVINCE	MISC	1
Ala\.?-born	STATE_OR_PROVINCE	MISC	1
Ala\.?-area	STATE_OR_PROVINCE	MISC	1
Ala\.?-registered	STATE_OR_PROVINCE	MISC	1
Alaska-headquartered	STATE_OR_PROVINCE	MISC	1
Alaska-owned	STATE_OR_PROVINCE	MISC	1
Alaska-controlled	STATE_OR_PROVINCE	MISC	1
Alaska-raised	STATE_OR_PROVINCE	MISC	1
Alaska-educated	STATE_OR_PROVINCE	MISC	1
Alaska-backed	STATE_OR_PROVINCE	MISC	1
Alaska-trained	STATE_OR_PROVINCE	MISC	1
Alaska-born	STATE_OR_PROVINCE	MISC	1
Alaska-area	STATE_OR_PROVINCE	MISC	1
Alaska-registered	STATE_OR_PROVINCE	MISC	1
Ariz\.?-headquartered	STATE_OR_PROVINCE	MISC	1
Ariz\.?-owned	STATE_OR_PROVINCE	MISC	1
Ariz\.?-controlled	STATE_OR_PROVINCE	MISC	1
Ariz\.?-raised	STATE_OR_PROVINCE	MISC	1
Ariz\.?-educated	STATE_OR_PROVINCE	MISC	1
Ariz\.?-backed	STATE_OR_PROVINCE	MISC	1
Ariz\.?-trained	STATE_OR_PROVINCE	MISC	1
Ariz\.?-born	STATE_OR_PROVINCE	MISC	1
Ariz\.?-area	STATE_OR_PROVINCE	MISC	1
Ariz\.?-registered	STATE_OR_PROVINCE	MISC	1
Ark\.?-headquartered	STATE_OR_PROVINCE	MISC	1
Ark\.?-owned	STATE_OR_PROVINCE	MISC	1
Ark\.?-controlled	STATE_OR_PROVINCE	MISC	1
Ark\.?-raised	STATE_OR_PROVINCE	MISC	1
Ark\.?-educated	STATE_OR_PROVINCE	MISC	1
Ark\.?-backed	STATE_OR_PROVINCE	MISC	1
Ark\.?-trained	STATE_OR_PROVINCE	MISC	1
Ark\.?-born	STATE_OR_PROVINCE	MISC	1
Ark\.?-area	STATE_OR_PROVINCE	MISC	1
Ark\.?-registered	STATE_OR_PROVINCE	MISC	1
Calif\.?-headquartered	STATE_OR_PROVINCE	MISC	1
Calif\.?-owned	STATE_OR_PROVINCE	MISC	1
Calif\.?-controlled	STATE_OR_PROVINCE	MISC	1
Calif\.?-raised	STATE_OR_PROVINCE	MISC	1
Calif\.?-educated	STATE_OR_PROVINCE	MISC	1
Calif\.?-backed	STATE_OR_PROVINCE	MISC	1
Calif\.?-trained	STATE_OR_PROVINCE	MISC	1
Calif\.?-born	STATE_OR_PROVINCE	MISC	1
Calif\.?-area	STATE_OR_PROVINCE	MISC	1
Calif\.?-registered	STATE_OR_PROVINCE	MISC	1
Colo\.?-headquartered	STATE_OR_PROVINCE	MISC	1
Colo\.?-owned	STATE_OR_PROVINCE	MISC	1
Colo\.?-controlled	STATE_OR_PROVINCE	MISC	1
Colo\.?-raised	STATE_OR_PROVINCE	MISC	1
Colo\.?-educated	STATE_OR_PROVINCE	MISC	1
Colo\.?-backed	STATE_OR_PROVINCE	MISC	1
Colo\.?-trained	STATE_OR_PROVINCE	MISC	1
Colo\.?-born	STATE_OR_PROVINCE	MISC	1
Colo\.?-area	STATE_OR_PROVINCE	MISC	1
Colo\.?-registered	STATE_OR_PROVINCE	MISC	1
Conn\.?-headquartered	STATE_OR_PROVINCE	MISC	1
Conn\.?-owned	STATE_OR_PROVINCE	MISC	1
Conn\.?-controlled	STATE_OR_PROVINCE	MISC	1
Conn\.?-raised	STATE_OR_PROVINCE	MISC	1
Conn\.?-educated	STATE_OR_PROVINCE	MISC	1
Conn\.?-backed	STATE_OR_PROVINCE	MISC	1
Conn\.?-trained	STATE_OR_PROVINCE	MISC	1
Conn\.?-born	STATE_OR_PROVINCE	MISC	1
Conn\.?-area	STATE_OR_PROVINCE	MISC	1
Conn\.?-registered	STATE_OR_PROVINCE	MISC	1
Del\.?-headquartered	STATE_OR_PROVINCE	MISC	1
Del\.?-owned	STATE_OR_PROVINCE	MISC	1
Del\.?-controlled	STATE_OR_PROVINCE	MISC	1
Del\.?-raised	STATE_OR_PROVINCE	MISC	1
Del\.?-educated	STATE_OR_PROVINCE	MISC	1
Del\.?-backed	STATE_OR_PROVINCE	MISC	1
Del\.?-trained	STATE_OR_PROVINCE	MISC	1
Del\.?-born	STATE_OR_PROVINCE	MISC	1
Del\.?-area	STATE_OR_PROVINCE	MISC	1
Del\.?-registered	STATE_OR_PROVINCE	MISC	1
Columbia-headquartered	STATE_OR_PROVINCE	MISC	1
Columbia-owned	STATE_OR_PROVINCE	MISC	1
Columbia-controlled	STATE_OR_PROVINCE	MISC	1
Columbia-raised	STATE_OR_PROVINCE	MISC	1
Columbia-educated	STATE_OR_PROVINCE	MISC	1
Columbia-backed	STATE_OR_PROVINCE	MISC	1
Columbia-trained	STATE_OR_PROVINCE	MISC	1
Columbia-born	STATE_OR_PROVINCE	MISC	1
Columbia-area	STATE_OR_PROVINCE	MISC	1
Columbia-registered	STATE_OR_PROVINCE	MISC	1
Fla\.?-headquartered	STATE_OR_PROVINCE	MISC	1
Fla\.?-owned	STATE_OR_PROVINCE	MISC	1
Fla\.?-controlled	STATE_OR_PROVINCE	MISC	1
Fla\.?-raised	STATE_OR_PROVINCE	MISC	1
Fla\.?-educated	STATE_OR_PROVINCE	MISC	1
Fla\.?-backed	STATE_OR_PROVINCE	MISC	1
Fla\.?-trained	STATE_OR_PROVINCE	MISC	1
Fla\.?-born	STATE_OR_PROVINCE	MISC	1
Fla\.?-area	STATE_OR_PROVINCE	MISC	1
Fla\.?-registered	STATE_OR_PROVINCE	MISC	1
Ga\.?-headquartered	STATE_OR_PROVINCE	MISC	1
Ga\.?-owned	STATE_OR_PROVINCE	MISC	1
Ga\.?-controlled	STATE_OR_PROVINCE	MISC	1
Ga\.?-raised	STATE_OR_PROVINCE	MISC	1
Ga\.?-educated	STATE_OR_PROVINCE	MISC	1
Ga\.?-backed	STATE_OR_PROVINCE	MISC	1
Ga\.?-trained	STATE_OR_PROVINCE	MISC	1
Ga\.?-born	STATE_OR_PROVINCE	MISC	1
Ga\.?-area	STATE_OR_PROVINCE	MISC	1
Ga\.?-registered	STATE_OR_PROVINCE	MISC	1
Hawaii-headquartered	STATE_OR_PROVINCE	MISC	1
Hawaii-owned	STATE_OR_PROVINCE	MISC	1
Hawaii-controlled	STATE_OR_PROVINCE	MISC	1
Hawaii-raised	STATE_OR_PROVINCE	MISC	1
Hawaii-educated	STATE_OR_PROVINCE	MISC	1
Hawaii-backed	STATE_OR_PROVINCE	MISC	1
Hawaii-trained	STATE_OR_PROVINCE	MISC	1
Hawaii-born	STATE_OR_PROVINCE	MISC	1
Hawaii-area	STATE_OR_PROVINCE	MISC	1
Hawaii-registered	STATE_OR_PROVINCE	MISC	1
Idaho-headquartered	STATE_OR_PROVINCE	MISC	1
Idaho-owned	STATE_OR_PROVINCE	MISC	1
Idaho-controlled	STATE_OR_PROVINCE	MISC	1
Idaho-raised	STATE_OR_PROVINCE	MISC	1
Idaho-educated	STATE_OR_PROVINCE	MISC	1
Idaho-backed	STATE_OR_PROVINCE	MISC	1
Idaho-trained	STATE_OR_PROVINCE	MISC	1
Idaho-born	STATE_OR_PROVINCE	MISC	1
Idaho-area	STATE_OR_PROVINCE	MISC	1
Idaho-registered	STATE_OR_PROVINCE	MISC	1
Ill\.?-headquartered	STATE_OR_PROVINCE	MISC	1
Ill\.?-owned	STATE_OR_PROVINCE	MISC	1
Ill\.?-controlled	STATE_OR_PROVINCE	MISC	1
Ill\.?-raised	STATE_OR_PROVINCE	MISC	1
Ill\.?-educated	STATE_OR_PROVINCE	MISC	1
Ill\.?-backed	STATE_OR_PROVINCE	MISC	1
Ill\.?-trained	STATE_OR_PROVINCE	MISC	1
Ill\.?-born	STATE_OR_PROVINCE	MISC	1
Ill\.?-area	STATE_OR_PROVINCE	MISC	1
Ill\.?-registered	STATE_OR_PROVINCE	MISC	1
Ind\.?-headquartered	STATE_OR_PROVINCE	MISC	1
Ind\.?-owned	STATE_OR_PROVINCE	MISC	1
Ind\.?-controlled	STATE_OR_PROVINCE	MISC	1
Ind\.?-raised	STATE_OR_PROVINCE	MISC	1
Ind\.?-educated	STATE_OR_PROVINCE	MISC	1
Ind\.?-backed	STATE_OR_PROVINCE	MISC	1
Ind\.?-trained	STATE_OR_PROVINCE	MISC	1
Ind\.?-born	STATE_OR_PROVINCE	MISC	1
Ind\.?-area	STATE_OR_PROVINCE	MISC	1
Ind\.?-registered	STATE_OR_PROVINCE	MISC	1
Iowa-headquartered	STATE_OR_PROVINCE	MISC	1
Iowa-owned	STATE_OR_PROVINCE	MISC	1
Iowa-controlled	STATE_OR_PROVINCE	MISC	1
Iowa-raised	STATE_OR_PROVINCE	MISC	1
Iowa-educated	STATE_OR_PROVINCE	MISC	1
Iowa-backed	STATE_OR_PROVINCE	MISC	1
Iowa-trained	STATE_OR_PROVINCE	MISC	1
Iowa-born	STATE_OR_PROVINCE	MISC	1
Iowa-area	STATE_OR_PROVINCE	MISC	1
Iowa-registered	STATE_OR_PROVINCE	MISC	1
Kans\.?-headquartered	STATE_OR_PROVINCE	MISC	1
Kans\.?-owned	STATE_OR_PROVINCE	MISC	1
Kans\.?-controlled	STATE_OR_PROVINCE	MISC	1
Kans\.?-raised	STATE_OR_PROVINCE	MISC	1
Kans\.?-educated	STATE_OR_PROVINCE	MISC	1
Kans\.?-backed	STATE_OR_PROVINCE	MISC	1
Kans\.?-trained	STATE_OR_PROVINCE	MISC	1
Kans\.?-born	STATE_OR_PROVINCE	MISC	1
Kans\.?-area	STATE_OR_PROVINCE	MISC	1
Kans\.?-registered	STATE_OR_PROVINCE	MISC	1
Ky\.?-headquartered	STATE_OR_PROVINCE	MISC	1
Ky\.?-owned	STATE_OR_PROVINCE	MISC	1
Ky\.?-controlled	STATE_OR_PROVINCE	MISC	1
Ky\.?-raised	STATE_OR_PROVINCE	MISC	1
Ky\.?-educated	STATE_OR_PROVINCE	MISC	1
Ky\.?-backed	STATE_OR_PROVINCE	MISC	1
Ky\.?-trained	STATE_OR_PROVINCE	MISC	1
Ky\.?-born	STATE_OR_PROVINCE	MISC	1
Ky\.?-area	STATE_OR_PROVINCE	MISC	1
Ky\.?-registered	STATE_OR_PROVINCE	MISC	1
La\.?-headquartered	STATE_OR_PROVINCE	MISC	1
La\.?-owned	STATE_OR_PROVINCE	MISC	1
La\.?-controlled	STATE_OR_PROVINCE	MISC	1
La\.?-raised	STATE_OR_PROVINCE	MISC	1
La\.?-educated	STATE_OR_PROVINCE	MISC	1
La\.?-backed	STATE_OR_PROVINCE	MISC	1
La\.?-trained	STATE_OR_PROVINCE	MISC	1
La\.?-born	STATE_OR_PROVINCE	MISC	1
La\.?-area	STATE_OR_PROVINCE	MISC	1
La\.?-registered	STATE_OR_PROVINCE	MISC	1
Maine-headquartered	STATE_OR_PROVINCE	MISC	1
Maine-owned	STATE_OR_PROVINCE	MISC	1
Maine-controlled	STATE_OR_PROVINCE	MISC	1
Maine-raised	STATE_OR_PROVINCE	MISC	1
Maine-educated	STATE_OR_PROVINCE	MISC	1
Maine-backed	STATE_OR_PROVINCE	MISC	1
Maine-trained	STATE_OR_PROVINCE	MISC	1
Maine-born	STATE_OR_PROVINCE	MISC	1
Maine-area	STATE_OR_PROVINCE	MISC	1
Maine-registered	STATE_OR_PROVINCE	MISC	1
Md\.?-headquartered	STATE_OR_PROVINCE	MISC	1
Md\.?-owned	STATE_OR_PROVINCE	MISC	1
Md\.?-controlled	STATE_OR_PROVINCE	MISC	1
Md\.?-raised	STATE_OR_PROVINCE	MISC	1
Md\.?-educated	STATE_OR_PROVINCE	MISC	1
Md\.?-backed	STATE_OR_PROVINCE	MISC	1
Md\.?-trained	STATE_OR_PROVINCE	MISC	1
Md\.?-born	STATE_OR_PROVINCE	MISC	1
Md\.?-area	STATE_OR_PROVINCE	MISC	1
Md\.?-registered	STATE_OR_PROVINCE	MISC	1
Mass\.?-headquartered	STATE_OR_PROVINCE	MISC	1
Mass\.?-owned	STATE_OR_PROVINCE	MISC	1
Mass\.?-controlled	STATE_OR_PROVINCE	MISC	1
Mass\.?-raised	STATE_OR_PROVINCE	MISC	1
Mass\.?-educated	STATE_OR_PROVINCE	MISC	1
Mass\.?-backed	STATE_OR_PROVINCE	MISC	1
Mass\.?-trained	STATE_OR_PROVINCE	MISC	1
Mass\.?-born	STATE_OR_PROVINCE	MISC	1
Mass\.?-area	STATE_OR_PROVINCE	MISC	1
Mass\.?-registered	STATE_OR_PROVINCE	MISC	1
Mich\.?-headquartered	STATE_OR_PROVINCE	MISC	1
Mich\.?-owned	STATE_OR_PROVINCE	MISC	1
Mich\.?-controlled	STATE_OR_PROVINCE	MISC	1
Mich\.?-raised	STATE_OR_PROVINCE	MISC	1
Mich\.?-educated	STATE_OR_PROVINCE	MISC	1
Mich\.?-backed	STATE_OR_PROVINCE	MISC	1
Mich\.?-trained	STATE_OR_PROVINCE	MISC	1
Mich\.?-born	STATE_OR_PROVINCE	MISC	1
Mich\.?-area	STATE_OR_PROVINCE	MISC	1
Mich\.?-registered	STATE_OR_PROVINCE	MISC	1
Minn\.?-headquartered	STATE_OR_PROVINCE	MISC	1
Minn\.?-owned	STATE_OR_PROVINCE	MISC	1
Minn\.?-controlled	STATE_OR_PROVINCE	MISC	1
Minn\.?-raised	STATE_OR_PROVINCE	MISC	1
Minn\.?-educated	STATE_OR_PROVINCE	MISC	1
Minn\.?-backed	STATE_OR_PROVINCE	MISC	1
Minn\.?-trained	STATE_OR_PROVINCE	MISC	1
Minn\.?-born	STATE_OR_PROVINCE	MISC	1
Minn\.?-area	STATE_OR_PROVINCE	MISC	1
Minn\.?-registered	STATE_OR_PROVINCE	MISC	1
Miss\.?-headquartered	STATE_OR_PROVINCE	MISC	1
Miss\.?-owned	STATE_OR_PROVINCE	MISC	1
Miss\.?-controlled	STATE_OR_PROVINCE	MISC	1
Miss\.?-raised	STATE_OR_PROVINCE	MISC	1
Miss\.?-educated	STATE_OR_PROVINCE	MISC	1
Miss\.?-backed	STATE_OR_PROVINCE	MISC	1
Miss\.?-trained	STATE_OR_PROVINCE	MISC	1
Miss\.?-born	STATE_OR_PROVINCE	MISC	1
Miss\.?-area	STATE_OR_PROVINCE	MISC	1
Miss\.?-registered	STATE_OR_PROVINCE	MISC	1
Mo\.?-headquartered	STATE_OR_PROVINCE	MISC	1
Mo\.?-owned	STATE_OR_PROVINCE	MISC	1
Mo\.?-controlled	STATE_OR_PROVINCE	MISC	1
Mo\.?-raised	STATE_OR_PROVINCE	MISC	1
Mo\.?-educated	STATE_OR_PROVINCE	MISC	1
Mo\.?-backed	STATE_OR_PROVINCE	MISC	1
Mo\.?-trained	STATE_OR_PROVINCE	MISC	1
Mo\.?-born	STATE_OR_PROVINCE	MISC	1
Mo\.?-area	STATE_OR_PROVINCE	MISC	1
Mo\.?-registered	STATE_OR_PROVINCE	MISC	1
Mont\.?-headquartered	STATE_OR_PROVINCE	MISC	1
Mont\.?-owned	STATE_OR_PROVINCE	MISC	1
Mont\.?-controlled	STATE_OR_PROVINCE	MISC	1
Mont\.?-raised	STATE_OR_PROVINCE	MISC	1
Mont\.?-educated	STATE_OR_PROVINCE	MISC	1
Mont\.?-backed	STATE_OR_PROVINCE	MISC	1
Mont\.?-trained	STATE_OR_PROVINCE	MISC	1
Mont\.?-born	STATE_OR_PROVINCE	MISC	1
Mont\.?-area	STATE_OR_PROVINCE	MISC	1
Mont\.?-registered	STATE_OR_PROVINCE	MISC	1
Neb\.?-headquartered	STATE_OR_PROVINCE	MISC	1
Neb\.?-owned	STATE_OR_PROVINCE	MISC	1
Neb\.?-controlled	STATE_OR_PROVINCE	MISC	1
Neb\.?-raised	STATE_OR_PROVINCE	MISC	1
Neb\.?-educated	STATE_OR_PROVINCE	MISC	1
Neb\.?-backed	STATE_OR_PROVINCE	MISC	1
Neb\.?-trained	STATE_OR_PROVINCE	MISC	1
Neb\.?-born	STATE_OR_PROVINCE	MISC	1
Neb\.?-area	STATE_OR_PROVINCE	MISC	1
Neb\.?-registered	STATE_OR_PROVINCE	MISC	1
Nev\.?-headquartered	STATE_OR_PROVINCE	MISC	1
Nev\.?-owned	STATE_OR_PROVINCE	MISC	1
Nev\.?-controlled	STATE_OR_PROVINCE	MISC	1
Nev\.?-raised	STATE_OR_PROVINCE	MISC	1
Nev\.?-educated	STATE_OR_PROVINCE	MISC	1
Nev\.?-backed	STATE_OR_PROVINCE	MISC	1
Nev\.?-trained	STATE_OR_PROVINCE	MISC	1
Nev\.?-born	STATE_OR_PROVINCE	MISC	1
Nev\.?-area	STATE_OR_PROVINCE	MISC	1
Nev\.?-registered	STATE_OR_PROVINCE	MISC	1
N\.?H\.?-headquartered	STATE_OR_PROVINCE	MISC	1
N\.?H\.?-owned	STATE_OR_PROVINCE	MISC	1
N\.?H\.?-controlled	STATE_OR_PROVINCE	MISC	1
N\.?H\.?-raised	STATE_OR_PROVINCE	MISC	1
N\.?H\.?-educated	STATE_OR_PROVINCE	MISC	1
N\.?H\.?-backed	STATE_OR_PROVINCE	MISC	1
N\.?H\.?-trained	STATE_OR_PROVINCE	MISC	1
N\.?H\.?-born	STATE_OR_PROVINCE	MISC	1
N\.?H\.?-area	STATE_OR_PROVINCE	MISC	1
N\.?H\.?-registered	STATE_OR_PROVINCE	MISC	1
N\.?J\.?-headquartered	STATE_OR_PROVINCE	MISC	1
N\.?J\.?-owned	STATE_OR_PROVINCE	MISC	1
N\.?J\.?-controlled	STATE_OR_PROVINCE	MISC	1
N\.?J\.?-raised	STATE_OR_PROVINCE	MISC	1
N\.?J\.?-educated	STATE_OR_PROVINCE	MISC	1
N\.?J\.?-backed	STATE_OR_PROVINCE	MISC	1
N\.?J\.?-trained	STATE_OR_PROVINCE	MISC	1
N\.?J\.?-born	STATE_OR_PROVINCE	MISC	1
N\.?J\.?-area	STATE_OR_PROVINCE	MISC	1
N\.?J\.?-registered	STATE_OR_PROVINCE	MISC	1
N\.?M\.?-headquartered	STATE_OR_PROVINCE	MISC	1
N\.?M\.?-owned	STATE_OR_PROVINCE	MISC	1
N\.?M\.?-controlled	STATE_OR_PROVINCE	MISC	1
N\.?M\.?-raised	STATE_OR_PROVINCE	MISC	1
N\.?M\.?-educated	STATE_OR_PROVINCE	MISC	1
N\.?M\.?-backed	STATE_OR_PROVINCE	MISC	1
N\.?M\.?-trained	STATE_OR_PROVINCE	MISC	1
N\.?M\.?-born	STATE_OR_PROVINCE	MISC	1
N\.?M\.?-area	STATE_OR_PROVINCE	MISC	1
N\.?M\.?-registered	STATE_OR_PROVINCE	MISC	1
N\.?Y\.?-headquartered	STATE_OR_PROVINCE	MISC	1
N\.?Y\.?-owned	STATE_OR_PROVINCE	MISC	1
N\.?Y\.?-controlled	STATE_OR_PROVINCE	MISC	1
N\.?Y\.?-raised	STATE_OR_PROVINCE	MISC	1
N\.?Y\.?-educated	STATE_OR_PROVINCE	MISC	1
N\.?Y\.?-backed	STATE_OR_PROVINCE	MISC	1
N\.?Y\.?-trained	STATE_OR_PROVINCE	MISC	1
N\.?Y\.?-born	STATE_OR_PROVINCE	MISC	1
N\.?Y\.?-area	STATE_OR_PROVINCE	MISC	1
N\.?Y\.?-registered	STATE_OR_PROVINCE	MISC	1
N\.?C\.?-headquartered	STATE_OR_PROVINCE	MISC	1
N\.?C\.?-owned	STATE_OR_PROVINCE	MISC	1
N\.?C\.?-controlled	STATE_OR_PROVINCE	MISC	1
N\.?C\.?-raised	STATE_OR_PROVINCE	MISC	1
N\.?C\.?-educated	STATE_OR_PROVINCE	MISC	1
N\.?C\.?-backed	STATE_OR_PROVINCE	MISC	1
N\.?C\.?-trained	STATE_OR_PROVINCE	MISC	1
N\.?C\.?-born	STATE_OR_PROVINCE	MISC	1
N\.?C\.?-area	STATE_OR_PROVINCE	MISC	1
N\.?C\.?-registered	STATE_OR_PROVINCE	MISC	1
N\.?D\.?-headquartered	STATE_OR_PROVINCE	MISC	1
N\.?D\.?-owned	STATE_OR_PROVINCE	MISC	1
N\.?D\.?-controlled	STATE_OR_PROVINCE	MISC	1
N\.?D\.?-raised	STATE_OR_PROVINCE	MISC	1
N\.?D\.?-educated	STATE_OR_PROVINCE	MISC	1
N\.?D\.?-backed	STATE_OR_PROVINCE	MISC	1
N\.?D\.?-trained	STATE_OR_PROVINCE	MISC	1
N\.?D\.?-born	STATE_OR_PROVINCE	MISC	1
N\.?D\.?-area	STATE_OR_PROVINCE	MISC	1
N\.?D\.?-registered	STATE_OR_PROVINCE	MISC	1
Ohio-headquartered	STATE_OR_PROVINCE	MISC	1
Ohio-owned	STATE_OR_PROVINCE	MISC	1
Ohio-controlled	STATE_OR_PROVINCE	MISC	1
Ohio-raised	STATE_OR_PROVINCE	MISC	1
Ohio-educated	STATE_OR_PROVINCE	MISC	1
Ohio-backed	STATE_OR_PROVINCE	MISC	1
Ohio-trained	STATE_OR_PROVINCE	MISC	1
Ohio-born	STATE_OR_PROVINCE	MISC	1
Ohio-area	STATE_OR_PROVINCE	MISC	1
Ohio-registered	STATE_OR_PROVINCE	MISC	1
Okla\.?-headquartered	STATE_OR_PROVINCE	MISC	1
Okla\.?-owned	STATE_OR_PROVINCE	MISC	1
Okla\.?-controlled	STATE_OR_PROVINCE	MISC	1
Okla\.?-raised	STATE_OR_PROVINCE	MISC	1
Okla\.?-educated	STATE_OR_PROVINCE	MISC	1
Okla\.?-backed	STATE_OR_PROVINCE	MISC	1
Okla\.?-trained	STATE_OR_PROVINCE	MISC	1
Okla\.?-born	STATE_OR_PROVINCE	MISC	1
Okla\.?-area	STATE_OR_PROVINCE	MISC	1
Okla\.?-registered	STATE_OR_PROVINCE	MISC	1
Ore\.?-headquartered	STATE_OR_PROVINCE	MISC	1
Ore\.?-owned	STATE_OR_PROVINCE	MISC	1
Ore\.?-controlled	STATE_OR_PROVINCE	MISC	1
Ore\.?-raised	STATE_OR_PROVINCE	MISC	1
Ore\.?-educated	STATE_OR_PROVINCE	MISC	1
Ore\.?-backed	STATE_OR_PROVINCE	MISC	1
Ore\.?-trained	STATE_OR_PROVINCE	MISC	1
Ore\.?-born	STATE_OR_PROVINCE	MISC	1
Ore\.?-area	STATE_OR_PROVINCE	MISC	1
Ore\.?-registered	STATE_OR_PROVINCE	MISC	1
P[Aa]\.?-headquartered	STATE_OR_PROVINCE	MISC	1
P[Aa]\.?-owned	STATE_OR_PROVINCE	MISC	1
P[Aa]\.?-controlled	STATE_OR_PROVINCE	MISC	1
P[Aa]\.?-raised	STATE_OR_PROVINCE	MISC	1
P[Aa]\.?-educated	STATE_OR_PROVINCE	MISC	1
P[Aa]\.?-backed	STATE_OR_PROVINCE	MISC	1
P[Aa]\.?-trained	STATE_OR_PROVINCE	MISC	1
P[Aa]\.?-born	STATE_OR_PROVINCE	MISC	1
P[Aa]\.?-area	STATE_OR_PROVINCE	MISC	1
P[Aa]\.?-registered	STATE_OR_PROVINCE	MISC	1
R\.?I\.?-headquartered	STATE_OR_PROVINCE	MISC	1
R\.?I\.?-owned	STATE_OR_PROVINCE	MISC	1
R\.?I\.?-controlled	STATE_OR_PROVINCE	MISC	1
R\.?I\.?-raised	STATE_OR_PROVINCE	MISC	1
R\.?I\.?-educated	STATE_OR_PROVINCE	MISC	1
R\.?I\.?-backed	STATE_OR_PROVINCE	MISC	1
R\.?I\.?-trained	STATE_OR_PROVINCE	MISC	1
R\.?I\.?-born	STATE_OR_PROVINCE	MISC	1
R\.?I\.?-area	STATE_OR_PROVINCE	MISC	1
R\.?I\.?-registered	STATE_OR_PROVINCE	MISC	1
S\.?C\.?-headquartered	STATE_OR_PROVINCE	MISC	1
S\.?C\.?-owned	STATE_OR_PROVINCE	MISC	1
S\.?C\.?-controlled	STATE_OR_PROVINCE	MISC	1
S\.?C\.?-raised	STATE_OR_PROVINCE	MISC	1
S\.?C\.?-educated	STATE_OR_PROVINCE	MISC	1
S\.?C\.?-backed	STATE_OR_PROVINCE	MISC	1
S\.?C\.?-trained	STATE_OR_PROVINCE	MISC	1
S\.?C\.?-born	STATE_OR_PROVINCE	MISC	1
S\.?C\.?-area	STATE_OR_PROVINCE	MISC	1
S\.?C\.?-registered	STATE_OR_PROVINCE	MISC	1
S\.?D\.?-headquartered	STATE_OR_PROVINCE	MISC	1
S\.?D\.?-owned	STATE_OR_PROVINCE	MISC	1
S\.?D\.?-controlled	STATE_OR_PROVINCE	MISC	1
S\.?D\.?-raised	STATE_OR_PROVINCE	MISC	1
S\.?D\.?-educated	STATE_OR_PROVINCE	MISC	1
S\.?D\.?-backed	STATE_OR_PROVINCE	MISC	1
S\.?D\.?-trained	STATE_OR_PROVINCE	MISC	1
S\.?D\.?-born	STATE_OR_PROVINCE	MISC	1
S\.?D\.?-area	STATE_OR_PROVINCE	MISC	1
S\.?D\.?-registered	STATE_OR_PROVINCE	MISC	1
Tenn\.?-headquartered	STATE_OR_PROVINCE	MISC	1
Tenn\.?-owned	STATE_OR_PROVINCE	MISC	1
Tenn\.?-controlled	STATE_OR_PROVINCE	MISC	1
Tenn\.?-raised	STATE_OR_PROVINCE	MISC	1
Tenn\.?-educated	STATE_OR_PROVINCE	MISC	1
Tenn\.?-backed	STATE_OR_PROVINCE	MISC	1
Tenn\.?-trained	STATE_OR_PROVINCE	MISC	1
Tenn\.?-born	STATE_OR_PROVINCE	MISC	1
Tenn\.?-area	STATE_OR_PROVINCE	MISC	1
Tenn\.?-registered	STATE_OR_PROVINCE	MISC	1
Tex\.?-headquartered	STATE_OR_PROVINCE	MISC	1
Tex\.?-owned	STATE_OR_PROVINCE	MISC	1
Tex\.?-controlled	STATE_OR_PROVINCE	MISC	1
Tex\.?-raised	STATE_OR_PROVINCE	MISC	1
Tex\.?-educated	STATE_OR_PROVINCE	MISC	1
Tex\.?-backed	STATE_OR_PROVINCE	MISC	1
Tex\.?-trained	STATE_OR_PROVINCE	MISC	1
Tex\.?-born	STATE_OR_PROVINCE	MISC	1
Tex\.?-area	STATE_OR_PROVINCE	MISC	1
Tex\.?-registered	STATE_OR_PROVINCE	MISC	1
Utah-headquartered	STATE_OR_PROVINCE	MISC	1
Utah-owned	STATE_OR_PROVINCE	MISC	1
Utah-controlled	STATE_OR_PROVINCE	MISC	1
Utah-raised	STATE_OR_PROVINCE	MISC	1
Utah-educated	STATE_OR_PROVINCE	MISC	1
Utah-backed	STATE_OR_PROVINCE	MISC	1
Utah-trained	STATE_OR_PROVINCE	MISC	1
Utah-born	STATE_OR_PROVINCE	MISC	1
Utah-area	STATE_OR_PROVINCE	MISC	1
Utah-registered	STATE_OR_PROVINCE	MISC	1
V[tT]\.?-headquartered	STATE_OR_PROVINCE	MISC	1
V[tT]\.?-owned	STATE_OR_PROVINCE	MISC	1
V[tT]\.?-controlled	STATE_OR_PROVINCE	MISC	1
V[tT]\.?-raised	STATE_OR_PROVINCE	MISC	1
V[tT]\.?-educated	STATE_OR_PROVINCE	MISC	1
V[tT]\.?-backed	STATE_OR_PROVINCE	MISC	1
V[tT]\.?-trained	STATE_OR_PROVINCE	MISC	1
V[tT]\.?-born	STATE_OR_PROVINCE	MISC	1
V[tT]\.?-area	STATE_OR_PROVINCE	MISC	1
V[tT]\.?-registered	STATE_OR_PROVINCE	MISC	1
V[aA]\.?-headquartered	STATE_OR_PROVINCE	MISC	1
V[aA]\.?-owned	STATE_OR_PROVINCE	MISC	1
V[aA]\.?-controlled	STATE_OR_PROVINCE	MISC	1
V[aA]\.?-raised	STATE_OR_PROVINCE	MISC	1
V[aA]\.?-educated	STATE_OR_PROVINCE	MISC	1
V[aA]\.?-backed	STATE_OR_PROVINCE	MISC	1
V[aA]\.?-trained	STATE_OR_PROVINCE	MISC	1
V[aA]\.?-born	STATE_OR_PROVINCE	MISC	1
V[aA]\.?-area	STATE_OR_PROVINCE	MISC	1
V[aA]\.?-registered	STATE_OR_PROVINCE	MISC	1
Wash\.?-headquartered	STATE_OR_PROVINCE	MISC	1
Wash\.?-owned	STATE_OR_PROVINCE	MISC	1
Wash\.?-controlled	STATE_OR_PROVINCE	MISC	1
Wash\.?-raised	STATE_OR_PROVINCE	MISC	1
Wash\.?-educated	STATE_OR_PROVINCE	MISC	1
Wash\.?-backed	STATE_OR_PROVINCE	MISC	1
Wash\.?-trained	STATE_OR_PROVINCE	MISC	1
Wash\.?-born	STATE_OR_PROVINCE	MISC	1
Wash\.?-area	STATE_OR_PROVINCE	MISC	1
Wash\.?-registered	STATE_OR_PROVINCE	MISC	1
W\.?V\.?-headquartered	STATE_OR_PROVINCE	MISC	1
W\.?V\.?-owned	STATE_OR_PROVINCE	MISC	1
W\.?V\.?-controlled	STATE_OR_PROVINCE	MISC	1
W\.?V\.?-raised	STATE_OR_PROVINCE	MISC	1
W\.?V\.?-educated	STATE_OR_PROVINCE	MISC	1
W\.?V\.?-backed	STATE_OR_PROVINCE	MISC	1
W\.?V\.?-trained	STATE_OR_PROVINCE	MISC	1
W\.?V\.?-born	STATE_OR_PROVINCE	MISC	1
W\.?V\.?-area	STATE_OR_PROVINCE	MISC	1
W\.?V\.?-registered	STATE_OR_PROVINCE	MISC	1
Wis\.?-headquartered	STATE_OR_PROVINCE	MISC	1
Wis\.?-owned	STATE_OR_PROVINCE	MISC	1
Wis\.?-controlled	STATE_OR_PROVINCE	MISC	1
Wis\.?-raised	STATE_OR_PROVINCE	MISC	1
Wis\.?-educated	STATE_OR_PROVINCE	MISC	1
Wis\.?-backed	STATE_OR_PROVINCE	MISC	1
Wis\.?-trained	STATE_OR_PROVINCE	MISC	1
Wis\.?-born	STATE_OR_PROVINCE	MISC	1
Wis\.?-area	STATE_OR_PROVINCE	MISC	1
Wis\.?-registered	STATE_OR_PROVINCE	MISC	1
Wyo\.?-headquartered	STATE_OR_PROVINCE	MISC	1
Wyo\.?-owned	STATE_OR_PROVINCE	MISC	1
Wyo\.?-controlled	STATE_OR_PROVINCE	MISC	1
Wyo\.?-raised	STATE_OR_PROVINCE	MISC	1
Wyo\.?-educated	STATE_OR_PROVINCE	MISC	1
Wyo\.?-backed	STATE_OR_PROVINCE	MISC	1
Wyo\.?-trained	STATE_OR_PROVINCE	MISC	1
Wyo\.?-born	STATE_OR_PROVINCE	MISC	1
Wyo\.?-area	STATE_OR_PROVINCE	MISC	1
Wyo\.?-registered	STATE_OR_PROVINCE	MISC	1
Alta\.?-headquartered	STATE_OR_PROVINCE	MISC	1
Alta\.?-owned	STATE_OR_PROVINCE	MISC	1
Alta\.?-controlled	STATE_OR_PROVINCE	MISC	1
Alta\.?-raised	STATE_OR_PROVINCE	MISC	1
Alta\.?-educated	STATE_OR_PROVINCE	MISC	1
Alta\.?-backed	STATE_OR_PROVINCE	MISC	1
Alta\.?-trained	STATE_OR_PROVINCE	MISC	1
Alta\.?-born	STATE_OR_PROVINCE	MISC	1
Alta\.?-area	STATE_OR_PROVINCE	MISC	1
Alta\.?-registered	STATE_OR_PROVINCE	MISC	1
B\.?C\.?-headquartered	STATE_OR_PROVINCE	MISC	1
B\.?C\.?-owned	STATE_OR_PROVINCE	MISC	1
B\.?C\.?-controlled	STATE_OR_PROVINCE	MISC	1
B\.?C\.?-raised	STATE_OR_PROVINCE	MISC	1
B\.?C\.?-educated	STATE_OR_PROVINCE	MISC	1
B\.?C\.?-backed	STATE_OR_PROVINCE	MISC	1
B\.?C\.?-trained	STATE_OR_PROVINCE	MISC	1
B\.?C\.?-born	STATE_OR_PROVINCE	MISC	1
B\.?C\.?-area	STATE_OR_PROVINCE	MISC	1
B\.?C\.?-registered	STATE_OR_PROVINCE	MISC	1
Man\.-headquartered	STATE_OR_PROVINCE	MISC	1
Man\.-owned	STATE_OR_PROVINCE	MISC	1
Man\.-controlled	STATE_OR_PROVINCE	MISC	1
Man\.-raised	STATE_OR_PROVINCE	MISC	1
Man\.-educated	STATE_OR_PROVINCE	MISC	1
Man\.-backed	STATE_OR_PROVINCE	MISC	1
Man\.-trained	STATE_OR_PROVINCE	MISC	1
Man\.-born	STATE_OR_PROVINCE	MISC	1
Man\.-area	STATE_OR_PROVINCE	MISC	1
Man\.-registered	STATE_OR_PROVINCE	MISC	1
N\.?B\.?-headquartered	STATE_OR_PROVINCE	MISC	1
N\.?B\.?-owned	STATE_OR_PROVINCE	MISC	1
N\.?B\.?-controlled	STATE_OR_PROVINCE	MISC	1
N\.?B\.?-raised	STATE_OR_PROVINCE	MISC	1
N\.?B\.?-educated	STATE_OR_PROVINCE	MISC	1
N\.?B\.?-backed	STATE_OR_PROVINCE	MISC	1
N\.?B\.?-trained	STATE_OR_PROVINCE	MISC	1
N\.?B\.?-born	STATE_OR_PROVINCE	MISC	1
N\.?B\.?-area	STATE_OR_PROVINCE	MISC	1
N\.?B\.?-registered	STATE_OR_PROVINCE	MISC	1
N\.?F\.?-headquartered	STATE_OR_PROVINCE	MISC	1
N\.?F\.?-owned	STATE_OR_PROVINCE	MISC	1
N\.?F\.?-controlled	STATE_OR_PROVINCE	MISC	1
N\.?F\.?-raised	STATE_OR_PROVINCE	MISC	1
N\.?F\.?-educated	STATE_OR_PROVINCE	MISC	1
N\.?F\.?-backed	STATE_OR_PROVINCE	MISC	1
N\.?F\.?-trained	STATE_OR_PROVINCE	MISC	1
N\.?F\.?-born	STATE_OR_PROVINCE	MISC	1
N\.?F\.?-area	STATE_OR_PROVINCE	MISC	1
N\.?F\.?-registered	STATE_OR_PROVINCE	MISC	1
N\.?W\.?T\.?-headquartered	STATE_OR_PROVINCE	MISC	1
N\.?W\.?T\.?-owned	STATE_OR_PROVINCE	MISC	1
N\.?W\.?T\.?-controlled	STATE_OR_PROVINCE	MISC	1
N\.?W\.?T\.?-raised	STATE_OR_PROVINCE	MISC	1
N\.?W\.?T\.?-educated	STATE_OR_PROVINCE	MISC	1
N\.?W\.?T\.?-backed	STATE_OR_PROVINCE	MISC	1
N\.?W\.?T\.?-trained	STATE_OR_PROVINCE	MISC	1
N\.?W\.?T\.?-born	STATE_OR_PROVINCE	MISC	1
N\.?W\.?T\.?-area	STATE_OR_PROVINCE	MISC	1
N\.?W\.?T\.?-registered	STATE_OR_PROVINCE	MISC	1
N\.?S\.?-headquartered	STATE_OR_PROVINCE	MISC	1
N\.?S\.?-owned	STATE_OR_PROVINCE	MISC	1
N\.?S\.?-controlled	STATE_OR_PROVINCE	MISC	1
N\.?S\.?-raised	STATE_OR_PROVINCE	MISC	1
N\.?S\.?-educated	STATE_OR_PROVINCE	MISC	1
N\.?S\.?-backed	STATE_OR_PROVINCE	MISC	1
N\.?S\.?-trained	STATE_OR_PROVINCE	MISC	1
N\.?S\.?-born	STATE_OR_PROVINCE	MISC	1
N\.?S\.?-area	STATE_OR_PROVINCE	MISC	1
N\.?S\.?-registered	STATE_OR_PROVINCE	MISC	1
Nunavut-headquartered	STATE_OR_PROVINCE	MISC	1
Nunavut-owned	STATE_OR_PROVINCE	MISC	1
Nunavut-controlled	STATE_OR_PROVINCE	MISC	1
Nunavut-raised	STATE_OR_PROVINCE	MISC	1
Nunavut-educated	STATE_OR_PROVINCE	MISC	1
Nunavut-backed	STATE_OR_PROVINCE	MISC	1
Nunavut-trained	STATE_OR_PROVINCE	MISC	1
Nunavut-born	STATE_OR_PROVINCE	MISC	1
Nunavut-area	STATE_OR_PROVINCE	MISC	1
Nunavut-registered	STATE_OR_PROVINCE	MISC	1
Ont\.?-headquartered	STATE_OR_PROVINCE	MISC	1
Ont\.?-owned	STATE_OR_PROVINCE	MISC	1
Ont\.?-controlled	STATE_OR_PROVINCE	MISC	1
Ont\.?-raised	STATE_OR_PROVINCE	MISC	1
Ont\.?-educated	STATE_OR_PROVINCE	MISC	1
Ont\.?-backed	STATE_OR_PROVINCE	MISC	1
Ont\.?-trained	STATE_OR_PROVINCE	MISC	1
Ont\.?-born	STATE_OR_PROVINCE	MISC	1
Ont\.?-area	STATE_OR_PROVINCE	MISC	1
Ont\.?-registered	STATE_OR_PROVINCE	MISC	1
P\.?E\.?I\.?-headquartered	STATE_OR_PROVINCE	MISC	1
P\.?E\.?I\.?-owned	STATE_OR_PROVINCE	MISC	1
P\.?E\.?I\.?-controlled	STATE_OR_PROVINCE	MISC	1
P\.?E\.?I\.?-raised	STATE_OR_PROVINCE	MISC	1
P\.?E\.?I\.?-educated	STATE_OR_PROVINCE	MISC	1
P\.?E\.?I\.?-backed	STATE_OR_PROVINCE	MISC	1
P\.?E\.?I\.?-trained	STATE_OR_PROVINCE	MISC	1
P\.?E\.?I\.?-born	STATE_OR_PROVINCE	MISC	1
P\.?E\.?I\.?-area	STATE_OR_PROVINCE	MISC	1
P\.?E\.?I\.?-registered	STATE_OR_PROVINCE	MISC	1
P\.?Q\.?-headquartered	STATE_OR_PROVINCE	MISC	1
P\.?Q\.?-owned	STATE_OR_PROVINCE	MISC	1
P\.?Q\.?-controlled	STATE_OR_PROVINCE	MISC	1
P\.?Q\.?-raised	STATE_OR_PROVINCE	MISC	1
P\.?Q\.?-educated	STATE_OR_PROVINCE	MISC	1
P\.?Q\.?-backed	STATE_OR_PROVINCE	MISC	1
P\.?Q\.?-trained	STATE_OR_PROVINCE	MISC	1
P\.?Q\.?-born	STATE_OR_PROVINCE	MISC	1
P\.?Q\.?-area	STATE_OR_PROVINCE	MISC	1
P\.?Q\.?-registered	STATE_OR_PROVINCE	MISC	1
Qu√©\.?-headquartered	STATE_OR_PROVINCE	MISC	1
Qu√©\.?-owned	STATE_OR_PROVINCE	MISC	1
Qu√©\.?-controlled	STATE_OR_PROVINCE	MISC	1
Qu√©\.?-raised	STATE_OR_PROVINCE	MISC	1
Qu√©\.?-educated	STATE_OR_PROVINCE	MISC	1
Qu√©\.?-backed	STATE_OR_PROVINCE	MISC	1
Qu√©\.?-trained	STATE_OR_PROVINCE	MISC	1
Qu√©\.?-born	STATE_OR_PROVINCE	MISC	1
Qu√©\.?-area	STATE_OR_PROVINCE	MISC	1
Qu√©\.?-registered	STATE_OR_PROVINCE	MISC	1
Sask\.?-headquartered	STATE_OR_PROVINCE	MISC	1
Sask\.?-owned	STATE_OR_PROVINCE	MISC	1
Sask\.?-controlled	STATE_OR_PROVINCE	MISC	1
Sask\.?-raised	STATE_OR_PROVINCE	MISC	1
Sask\.?-educated	STATE_OR_PROVINCE	MISC	1
Sask\.?-backed	STATE_OR_PROVINCE	MISC	1
Sask\.?-trained	STATE_OR_PROVINCE	MISC	1
Sask\.?-born	STATE_OR_PROVINCE	MISC	1
Sask\.?-area	STATE_OR_PROVINCE	MISC	1
Sask\.?-registered	STATE_OR_PROVINCE	MISC	1
Yuk\.?-headquartered	STATE_OR_PROVINCE	MISC	1
Yuk\.?-owned	STATE_OR_PROVINCE	MISC	1
Yuk\.?-controlled	STATE_OR_PROVINCE	MISC	1
Yuk\.?-raised	STATE_OR_PROVINCE	MISC	1
Yuk\.?-educated	STATE_OR_PROVINCE	MISC	1
Yuk\.?-backed	STATE_OR_PROVINCE	MISC	1
Yuk\.?-trained	STATE_OR_PROVINCE	MISC	1
Yuk\.?-born	STATE_OR_PROVINCE	MISC	1
Yuk\.?-area	STATE_OR_PROVINCE	MISC	1
Yuk\.?-registered	STATE_OR_PROVINCE	MISC	1
Y\.?T\.?-headquartered	STATE_OR_PROVINCE	MISC	1
Y\.?T\.?-owned	STATE_OR_PROVINCE	MISC	1
Y\.?T\.?-controlled	STATE_OR_PROVINCE	MISC	1
Y\.?T\.?-raised	STATE_OR_PROVINCE	MISC	1
Y\.?T\.?-educated	STATE_OR_PROVINCE	MISC	1
Y\.?T\.?-backed	STATE_OR_PROVINCE	MISC	1
Y\.?T\.?-trained	STATE_OR_PROVINCE	MISC	1
Y\.?T\.?-born	STATE_OR_PROVINCE	MISC	1
Y\.?T\.?-area	STATE_OR_PROVINCE	MISC	1
Y\.?T\.?-registered	STATE_OR_PROVINCE	MISC	1
L\.?A\.?-headquartered	CITY	MISC	1
L\.?A\.?-owned	CITY	MISC	1
L\.?A\.?-controlled	CITY	MISC	1
L\.?A\.?-raised	CITY	MISC	1
L\.?A\.?-educated	CITY	MISC	1
L\.?A\.?-backed	CITY	MISC	1
L\.?A\.?-trained	CITY	MISC	1
L\.?A\.?-born	CITY	MISC	1
L\.?A\.?-area	CITY	MISC	1
L\.?A\.?-registered	CITY	MISC	1
S\.?F\.?-headquartered	CITY	MISC	1
S\.?F\.?-owned	CITY	MISC	1
S\.?F\.?-controlled	CITY	MISC	1
S\.?F\.?-raised	CITY	MISC	1
S\.?F\.?-educated	CITY	MISC	1
S\.?F\.?-backed	CITY	MISC	1
S\.?F\.?-trained	CITY	MISC	1
S\.?F\.?-born	CITY	MISC	1
S\.?F\.?-area	CITY	MISC	1
S\.?F\.?-registered	CITY	MISC	1
S\.?J\.?-headquartered	CITY	MISC	1
S\.?J\.?-owned	CITY	MISC	1
S\.?J\.?-controlled	CITY	MISC	1
S\.?J\.?-raised	CITY	MISC	1
S\.?J\.?-educated	CITY	MISC	1
S\.?J\.?-backed	CITY	MISC	1
S\.?J\.?-trained	CITY	MISC	1
S\.?J\.?-born	CITY	MISC	1
S\.?J\.?-area	CITY	MISC	1
S\.?J\.?-registered	CITY	MISC	1
N\.?Y\.?-headquartered	CITY	MISC	1
N\.?Y\.?-owned	CITY	MISC	1
N\.?Y\.?-controlled	CITY	MISC	1
N\.?Y\.?-raised	CITY	MISC	1
N\.?Y\.?-educated	CITY	MISC	1
N\.?Y\.?-backed	CITY	MISC	1
N\.?Y\.?-trained	CITY	MISC	1
N\.?Y\.?-born	CITY	MISC	1
N\.?Y\.?-area	CITY	MISC	1
N\.?Y\.?-registered	CITY	MISC	1
Acevedo-headquartered	CITY	MISC	1
Acevedo-owned	CITY	MISC	1
Acevedo-controlled	CITY	MISC	1
Acevedo-raised	CITY	MISC	1
Acevedo-educated	CITY	MISC	1
Acevedo-backed	CITY	MISC	1
Acevedo-trained	CITY	MISC	1
Acevedo-born	CITY	MISC	1
Acevedo-area	CITY	MISC	1
Acevedo-registered	CITY	MISC	1
Aguilar-headquartered	CITY	MISC	1
Aguilar-owned	CITY	MISC	1
Aguilar-controlled	CITY	MISC	1
Aguilar-raised	CITY	MISC	1
Aguilar-educated	CITY	MISC	1
Aguilar-backed	CITY	MISC	1
Aguilar-trained	CITY	MISC	1
Aguilar-born	CITY	MISC	1
Aguilar-area	CITY	MISC	1
Aguilar-registered	CITY	MISC	1
Allen-headquartered	CITY	MISC	1
Allen-owned	CITY	MISC	1
Allen-controlled	CITY	MISC	1
Allen-raised	CITY	MISC	1
Allen-educated	CITY	MISC	1
Allen-backed	CITY	MISC	1
Allen-trained	CITY	MISC	1
Allen-born	CITY	MISC	1
Allen-area	CITY	MISC	1
Allen-registered	CITY	MISC	1
Alvarado-headquartered	CITY	MISC	1
Alvarado-owned	CITY	MISC	1
Alvarado-controlled	CITY	MISC	1
Alvarado-raised	CITY	MISC	1
Alvarado-educated	CITY	MISC	1
Alvarado-backed	CITY	MISC	1
Alvarado-trained	CITY	MISC	1
Alvarado-born	CITY	MISC	1
Alvarado-area	CITY	MISC	1
Alvarado-registered	CITY	MISC	1
Anderson-headquartered	CITY	MISC	1
Anderson-owned	CITY	MISC	1
Anderson-controlled	CITY	MISC	1
Anderson-raised	CITY	MISC	1
Anderson-educated	CITY	MISC	1
Anderson-backed	CITY	MISC	1
Anderson-trained	CITY	MISC	1
Anderson-born	CITY	MISC	1
Anderson-area	CITY	MISC	1
Anderson-registered	CITY	MISC	1
Andrews-headquartered	CITY	MISC	1
Andrews-owned	CITY	MISC	1
Andrews-controlled	CITY	MISC	1
Andrews-raised	CITY	MISC	1
Andrews-educated	CITY	MISC	1
Andrews-backed	CITY	MISC	1
Andrews-trained	CITY	MISC	1
Andrews-born	CITY	MISC	1
Andrews-area	CITY	MISC	1
Andrews-registered	CITY	MISC	1
Armstrong-headquartered	CITY	MISC	1
Armstrong-owned	CITY	MISC	1
Armstrong-controlled	CITY	MISC	1
Armstrong-raised	CITY	MISC	1
Armstrong-educated	CITY	MISC	1
Armstrong-backed	CITY	MISC	1
Armstrong-trained	CITY	MISC	1
Armstrong-born	CITY	MISC	1
Armstrong-area	CITY	MISC	1
Armstrong-registered	CITY	MISC	1
Arnold-headquartered	CITY	MISC	1
Arnold-owned	CITY	MISC	1
Arnold-controlled	CITY	MISC	1
Arnold-raised	CITY	MISC	1
Arnold-educated	CITY	MISC	1
Arnold-backed	CITY	MISC	1
Arnold-trained	CITY	MISC	1
Arnold-born	CITY	MISC	1
Arnold-area	CITY	MISC	1
Arnold-registered	CITY	MISC	1
Atkinson-headquartered	CITY	MISC	1
Atkinson-owned	CITY	MISC	1
Atkinson-controlled	CITY	MISC	1
Atkinson-raised	CITY	MISC	1
Atkinson-educated	CITY	MISC	1
Atkinson-backed	CITY	MISC	1
Atkinson-trained	CITY	MISC	1
Atkinson-born	CITY	MISC	1
Atkinson-area	CITY	MISC	1
Atkinson-registered	CITY	MISC	1
Austin-headquartered	CITY	MISC	1
Austin-owned	CITY	MISC	1
Austin-controlled	CITY	MISC	1
Austin-raised	CITY	MISC	1
Austin-educated	CITY	MISC	1
Austin-backed	CITY	MISC	1
Austin-trained	CITY	MISC	1
Austin-born	CITY	MISC	1
Austin-area	CITY	MISC	1
Austin-registered	CITY	MISC	1
Avila-headquartered	CITY	MISC	1
Avila-owned	CITY	MISC	1
Avila-controlled	CITY	MISC	1
Avila-raised	CITY	MISC	1
Avila-educated	CITY	MISC	1
Avila-backed	CITY	MISC	1
Avila-trained	CITY	MISC	1
Avila-born	CITY	MISC	1
Avila-area	CITY	MISC	1
Avila-registered	CITY	MISC	1
Ayala-headquartered	CITY	MISC	1
Ayala-owned	CITY	MISC	1
Ayala-controlled	CITY	MISC	1
Ayala-raised	CITY	MISC	1
Ayala-educated	CITY	MISC	1
Ayala-backed	CITY	MISC	1
Ayala-trained	CITY	MISC	1
Ayala-born	CITY	MISC	1
Ayala-area	CITY	MISC	1
Ayala-registered	CITY	MISC	1
Baker-headquartered	CITY	MISC	1
Baker-owned	CITY	MISC	1
Baker-controlled	CITY	MISC	1
Baker-raised	CITY	MISC	1
Baker-educated	CITY	MISC	1
Baker-backed	CITY	MISC	1
Baker-trained	CITY	MISC	1
Baker-born	CITY	MISC	1
Baker-area	CITY	MISC	1
Baker-registered	CITY	MISC	1
Baldwin-headquartered	CITY	MISC	1
Baldwin-owned	CITY	MISC	1
Baldwin-controlled	CITY	MISC	1
Baldwin-raised	CITY	MISC	1
Baldwin-educated	CITY	MISC	1
Baldwin-backed	CITY	MISC	1
Baldwin-trained	CITY	MISC	1
Baldwin-born	CITY	MISC	1
Baldwin-area	CITY	MISC	1
Baldwin-registered	CITY	MISC	1
Barry-headquartered	CITY	MISC	1
Barry-owned	CITY	MISC	1
Barry-controlled	CITY	MISC	1
Barry-raised	CITY	MISC	1
Barry-educated	CITY	MISC	1
Barry-backed	CITY	MISC	1
Barry-trained	CITY	MISC	1
Barry-born	CITY	MISC	1
Barry-area	CITY	MISC	1
Barry-registered	CITY	MISC	1
Bartlett-headquartered	CITY	MISC	1
Bartlett-owned	CITY	MISC	1
Bartlett-controlled	CITY	MISC	1
Bartlett-raised	CITY	MISC	1
Bartlett-educated	CITY	MISC	1
Bartlett-backed	CITY	MISC	1
Bartlett-trained	CITY	MISC	1
Bartlett-born	CITY	MISC	1
Bartlett-area	CITY	MISC	1
Bartlett-registered	CITY	MISC	1
Bautista-headquartered	CITY	MISC	1
Bautista-owned	CITY	MISC	1
Bautista-controlled	CITY	MISC	1
Bautista-raised	CITY	MISC	1
Bautista-educated	CITY	MISC	1
Bautista-backed	CITY	MISC	1
Bautista-trained	CITY	MISC	1
Bautista-born	CITY	MISC	1
Bautista-area	CITY	MISC	1
Bautista-registered	CITY	MISC	1
Bell-headquartered	CITY	MISC	1
Bell-owned	CITY	MISC	1
Bell-controlled	CITY	MISC	1
Bell-raised	CITY	MISC	1
Bell-educated	CITY	MISC	1
Bell-backed	CITY	MISC	1
Bell-trained	CITY	MISC	1
Bell-born	CITY	MISC	1
Bell-area	CITY	MISC	1
Bell-registered	CITY	MISC	1
Beltran-headquartered	CITY	MISC	1
Beltran-owned	CITY	MISC	1
Beltran-controlled	CITY	MISC	1
Beltran-raised	CITY	MISC	1
Beltran-educated	CITY	MISC	1
Beltran-backed	CITY	MISC	1
Beltran-trained	CITY	MISC	1
Beltran-born	CITY	MISC	1
Beltran-area	CITY	MISC	1
Beltran-registered	CITY	MISC	1
Bentley-headquartered	CITY	MISC	1
Bentley-owned	CITY	MISC	1
Bentley-controlled	CITY	MISC	1
Bentley-raised	CITY	MISC	1
Bentley-educated	CITY	MISC	1
Bentley-backed	CITY	MISC	1
Bentley-trained	CITY	MISC	1
Bentley-born	CITY	MISC	1
Bentley-area	CITY	MISC	1
Bentley-registered	CITY	MISC	1
Benton-headquartered	CITY	MISC	1
Benton-owned	CITY	MISC	1
Benton-controlled	CITY	MISC	1
Benton-raised	CITY	MISC	1
Benton-educated	CITY	MISC	1
Benton-backed	CITY	MISC	1
Benton-trained	CITY	MISC	1
Benton-born	CITY	MISC	1
Benton-area	CITY	MISC	1
Benton-registered	CITY	MISC	1
Berg-headquartered	CITY	MISC	1
Berg-owned	CITY	MISC	1
Berg-controlled	CITY	MISC	1
Berg-raised	CITY	MISC	1
Berg-educated	CITY	MISC	1
Berg-backed	CITY	MISC	1
Berg-trained	CITY	MISC	1
Berg-born	CITY	MISC	1
Berg-area	CITY	MISC	1
Berg-registered	CITY	MISC	1
Berger-headquartered	CITY	MISC	1
Berger-owned	CITY	MISC	1
Berger-controlled	CITY	MISC	1
Berger-raised	CITY	MISC	1
Berger-educated	CITY	MISC	1
Berger-backed	CITY	MISC	1
Berger-trained	CITY	MISC	1
Berger-born	CITY	MISC	1
Berger-area	CITY	MISC	1
Berger-registered	CITY	MISC	1
Blackburn-headquartered	CITY	MISC	1
Blackburn-owned	CITY	MISC	1
Blackburn-controlled	CITY	MISC	1
Blackburn-raised	CITY	MISC	1
Blackburn-educated	CITY	MISC	1
Blackburn-backed	CITY	MISC	1
Blackburn-trained	CITY	MISC	1
Blackburn-born	CITY	MISC	1
Blackburn-area	CITY	MISC	1
Blackburn-registered	CITY	MISC	1
Bolton-headquartered	CITY	MISC	1
Bolton-owned	CITY	MISC	1
Bolton-controlled	CITY	MISC	1
Bolton-raised	CITY	MISC	1
Bolton-educated	CITY	MISC	1
Bolton-backed	CITY	MISC	1
Bolton-trained	CITY	MISC	1
Bolton-born	CITY	MISC	1
Bolton-area	CITY	MISC	1
Bolton-registered	CITY	MISC	1
Boone-headquartered	CITY	MISC	1
Boone-owned	CITY	MISC	1
Boone-controlled	CITY	MISC	1
Boone-raised	CITY	MISC	1
Boone-educated	CITY	MISC	1
Boone-backed	CITY	MISC	1
Boone-trained	CITY	MISC	1
Boone-born	CITY	MISC	1
Boone-area	CITY	MISC	1
Boone-registered	CITY	MISC	1
Bowen-headquartered	CITY	MISC	1
Bowen-owned	CITY	MISC	1
Bowen-controlled	CITY	MISC	1
Bowen-raised	CITY	MISC	1
Bowen-educated	CITY	MISC	1
Bowen-backed	CITY	MISC	1
Bowen-trained	CITY	MISC	1
Bowen-born	CITY	MISC	1
Bowen-area	CITY	MISC	1
Bowen-registered	CITY	MISC	1
Boyle-headquartered	CITY	MISC	1
Boyle-owned	CITY	MISC	1
Boyle-controlled	CITY	MISC	1
Boyle-raised	CITY	MISC	1
Boyle-educated	CITY	MISC	1
Boyle-backed	CITY	MISC	1
Boyle-trained	CITY	MISC	1
Boyle-born	CITY	MISC	1
Boyle-area	CITY	MISC	1
Boyle-registered	CITY	MISC	1
Bradford-headquartered	CITY	MISC	1
Bradford-owned	CITY	MISC	1
Bradford-controlled	CITY	MISC	1
Bradford-raised	CITY	MISC	1
Bradford-educated	CITY	MISC	1
Bradford-backed	CITY	MISC	1
Bradford-trained	CITY	MISC	1
Bradford-born	CITY	MISC	1
Bradford-area	CITY	MISC	1
Bradford-registered	CITY	MISC	1
Bradley-headquartered	CITY	MISC	1
Bradley-owned	CITY	MISC	1
Bradley-controlled	CITY	MISC	1
Bradley-raised	CITY	MISC	1
Bradley-educated	CITY	MISC	1
Bradley-backed	CITY	MISC	1
Bradley-trained	CITY	MISC	1
Bradley-born	CITY	MISC	1
Bradley-area	CITY	MISC	1
Bradley-registered	CITY	MISC	1
Bray-headquartered	CITY	MISC	1
Bray-owned	CITY	MISC	1
Bray-controlled	CITY	MISC	1
Bray-raised	CITY	MISC	1
Bray-educated	CITY	MISC	1
Bray-backed	CITY	MISC	1
Bray-trained	CITY	MISC	1
Bray-born	CITY	MISC	1
Bray-area	CITY	MISC	1
Bray-registered	CITY	MISC	1
Brewer-headquartered	CITY	MISC	1
Brewer-owned	CITY	MISC	1
Brewer-controlled	CITY	MISC	1
Brewer-raised	CITY	MISC	1
Brewer-educated	CITY	MISC	1
Brewer-backed	CITY	MISC	1
Brewer-trained	CITY	MISC	1
Brewer-born	CITY	MISC	1
Brewer-area	CITY	MISC	1
Brewer-registered	CITY	MISC	1
Brooks-headquartered	CITY	MISC	1
Brooks-owned	CITY	MISC	1
Brooks-controlled	CITY	MISC	1
Brooks-raised	CITY	MISC	1
Brooks-educated	CITY	MISC	1
Brooks-backed	CITY	MISC	1
Brooks-trained	CITY	MISC	1
Brooks-born	CITY	MISC	1
Brooks-area	CITY	MISC	1
Brooks-registered	CITY	MISC	1
Bryan-headquartered	CITY	MISC	1
Bryan-owned	CITY	MISC	1
Bryan-controlled	CITY	MISC	1
Bryan-raised	CITY	MISC	1
Bryan-educated	CITY	MISC	1
Bryan-backed	CITY	MISC	1
Bryan-trained	CITY	MISC	1
Bryan-born	CITY	MISC	1
Bryan-area	CITY	MISC	1
Bryan-registered	CITY	MISC	1
Bryant-headquartered	CITY	MISC	1
Bryant-owned	CITY	MISC	1
Bryant-controlled	CITY	MISC	1
Bryant-raised	CITY	MISC	1
Bryant-educated	CITY	MISC	1
Bryant-backed	CITY	MISC	1
Bryant-trained	CITY	MISC	1
Bryant-born	CITY	MISC	1
Bryant-area	CITY	MISC	1
Bryant-registered	CITY	MISC	1
Buchanan-headquartered	CITY	MISC	1
Buchanan-owned	CITY	MISC	1
Buchanan-controlled	CITY	MISC	1
Buchanan-raised	CITY	MISC	1
Buchanan-educated	CITY	MISC	1
Buchanan-backed	CITY	MISC	1
Buchanan-trained	CITY	MISC	1
Buchanan-born	CITY	MISC	1
Buchanan-area	CITY	MISC	1
Buchanan-registered	CITY	MISC	1
Burke-headquartered	CITY	MISC	1
Burke-owned	CITY	MISC	1
Burke-controlled	CITY	MISC	1
Burke-raised	CITY	MISC	1
Burke-educated	CITY	MISC	1
Burke-backed	CITY	MISC	1
Burke-trained	CITY	MISC	1
Burke-born	CITY	MISC	1
Burke-area	CITY	MISC	1
Burke-registered	CITY	MISC	1
Burton-headquartered	CITY	MISC	1
Burton-owned	CITY	MISC	1
Burton-controlled	CITY	MISC	1
Burton-raised	CITY	MISC	1
Burton-educated	CITY	MISC	1
Burton-backed	CITY	MISC	1
Burton-trained	CITY	MISC	1
Burton-born	CITY	MISC	1
Burton-area	CITY	MISC	1
Burton-registered	CITY	MISC	1
Butler-headquartered	CITY	MISC	1
Butler-owned	CITY	MISC	1
Butler-controlled	CITY	MISC	1
Butler-raised	CITY	MISC	1
Butler-educated	CITY	MISC	1
Butler-backed	CITY	MISC	1
Butler-trained	CITY	MISC	1
Butler-born	CITY	MISC	1
Butler-area	CITY	MISC	1
Butler-registered	CITY	MISC	1
Cabrera-headquartered	CITY	MISC	1
Cabrera-owned	CITY	MISC	1
Cabrera-controlled	CITY	MISC	1
Cabrera-raised	CITY	MISC	1
Cabrera-educated	CITY	MISC	1
Cabrera-backed	CITY	MISC	1
Cabrera-trained	CITY	MISC	1
Cabrera-born	CITY	MISC	1
Cabrera-area	CITY	MISC	1
Cabrera-registered	CITY	MISC	1
Caldwell-headquartered	CITY	MISC	1
Caldwell-owned	CITY	MISC	1
Caldwell-controlled	CITY	MISC	1
Caldwell-raised	CITY	MISC	1
Caldwell-educated	CITY	MISC	1
Caldwell-backed	CITY	MISC	1
Caldwell-trained	CITY	MISC	1
Caldwell-born	CITY	MISC	1
Caldwell-area	CITY	MISC	1
Caldwell-registered	CITY	MISC	1
Calhoun-headquartered	CITY	MISC	1
Calhoun-owned	CITY	MISC	1
Calhoun-controlled	CITY	MISC	1
Calhoun-raised	CITY	MISC	1
Calhoun-educated	CITY	MISC	1
Calhoun-backed	CITY	MISC	1
Calhoun-trained	CITY	MISC	1
Calhoun-born	CITY	MISC	1
Calhoun-area	CITY	MISC	1
Calhoun-registered	CITY	MISC	1
Campbell-headquartered	CITY	MISC	1
Campbell-owned	CITY	MISC	1
Campbell-controlled	CITY	MISC	1
Campbell-raised	CITY	MISC	1
Campbell-educated	CITY	MISC	1
Campbell-backed	CITY	MISC	1
Campbell-trained	CITY	MISC	1
Campbell-born	CITY	MISC	1
Campbell-area	CITY	MISC	1
Campbell-registered	CITY	MISC	1
Campos-headquartered	CITY	MISC	1
Campos-owned	CITY	MISC	1
Campos-controlled	CITY	MISC	1
Campos-raised	CITY	MISC	1
Campos-educated	CITY	MISC	1
Campos-backed	CITY	MISC	1
Campos-trained	CITY	MISC	1
Campos-born	CITY	MISC	1
Campos-area	CITY	MISC	1
Campos-registered	CITY	MISC	1
Cantu-headquartered	CITY	MISC	1
Cantu-owned	CITY	MISC	1
Cantu-controlled	CITY	MISC	1
Cantu-raised	CITY	MISC	1
Cantu-educated	CITY	MISC	1
Cantu-backed	CITY	MISC	1
Cantu-trained	CITY	MISC	1
Cantu-born	CITY	MISC	1
Cantu-area	CITY	MISC	1
Cantu-registered	CITY	MISC	1
Cardenas-headquartered	CITY	MISC	1
Cardenas-owned	CITY	MISC	1
Cardenas-controlled	CITY	MISC	1
Cardenas-raised	CITY	MISC	1
Cardenas-educated	CITY	MISC	1
Cardenas-backed	CITY	MISC	1
Cardenas-trained	CITY	MISC	1
Cardenas-born	CITY	MISC	1
Cardenas-area	CITY	MISC	1
Cardenas-registered	CITY	MISC	1
Carney-headquartered	CITY	MISC	1
Carney-owned	CITY	MISC	1
Carney-controlled	CITY	MISC	1
Carney-raised	CITY	MISC	1
Carney-educated	CITY	MISC	1
Carney-backed	CITY	MISC	1
Carney-trained	CITY	MISC	1
Carney-born	CITY	MISC	1
Carney-area	CITY	MISC	1
Carney-registered	CITY	MISC	1
Carroll-headquartered	CITY	MISC	1
Carroll-owned	CITY	MISC	1
Carroll-controlled	CITY	MISC	1
Carroll-raised	CITY	MISC	1
Carroll-educated	CITY	MISC	1
Carroll-backed	CITY	MISC	1
Carroll-trained	CITY	MISC	1
Carroll-born	CITY	MISC	1
Carroll-area	CITY	MISC	1
Carroll-registered	CITY	MISC	1
Carson-headquartered	CITY	MISC	1
Carson-owned	CITY	MISC	1
Carson-controlled	CITY	MISC	1
Carson-raised	CITY	MISC	1
Carson-educated	CITY	MISC	1
Carson-backed	CITY	MISC	1
Carson-trained	CITY	MISC	1
Carson-born	CITY	MISC	1
Carson-area	CITY	MISC	1
Carson-registered	CITY	MISC	1
Castillo-headquartered	CITY	MISC	1
Castillo-owned	CITY	MISC	1
Castillo-controlled	CITY	MISC	1
Castillo-raised	CITY	MISC	1
Castillo-educated	CITY	MISC	1
Castillo-backed	CITY	MISC	1
Castillo-trained	CITY	MISC	1
Castillo-born	CITY	MISC	1
Castillo-area	CITY	MISC	1
Castillo-registered	CITY	MISC	1
Castro-headquartered	CITY	MISC	1
Castro-owned	CITY	MISC	1
Castro-controlled	CITY	MISC	1
Castro-raised	CITY	MISC	1
Castro-educated	CITY	MISC	1
Castro-backed	CITY	MISC	1
Castro-trained	CITY	MISC	1
Castro-born	CITY	MISC	1
Castro-area	CITY	MISC	1
Castro-registered	CITY	MISC	1
Cervantes-headquartered	CITY	MISC	1
Cervantes-owned	CITY	MISC	1
Cervantes-controlled	CITY	MISC	1
Cervantes-raised	CITY	MISC	1
Cervantes-educated	CITY	MISC	1
Cervantes-backed	CITY	MISC	1
Cervantes-trained	CITY	MISC	1
Cervantes-born	CITY	MISC	1
Cervantes-area	CITY	MISC	1
Cervantes-registered	CITY	MISC	1
Chandler-headquartered	CITY	MISC	1
Chandler-owned	CITY	MISC	1
Chandler-controlled	CITY	MISC	1
Chandler-raised	CITY	MISC	1
Chandler-educated	CITY	MISC	1
Chandler-backed	CITY	MISC	1
Chandler-trained	CITY	MISC	1
Chandler-born	CITY	MISC	1
Chandler-area	CITY	MISC	1
Chandler-registered	CITY	MISC	1
Chase-headquartered	CITY	MISC	1
Chase-owned	CITY	MISC	1
Chase-controlled	CITY	MISC	1
Chase-raised	CITY	MISC	1
Chase-educated	CITY	MISC	1
Chase-backed	CITY	MISC	1
Chase-trained	CITY	MISC	1
Chase-born	CITY	MISC	1
Chase-area	CITY	MISC	1
Chase-registered	CITY	MISC	1
Cisneros-headquartered	CITY	MISC	1
Cisneros-owned	CITY	MISC	1
Cisneros-controlled	CITY	MISC	1
Cisneros-raised	CITY	MISC	1
Cisneros-educated	CITY	MISC	1
Cisneros-backed	CITY	MISC	1
Cisneros-trained	CITY	MISC	1
Cisneros-born	CITY	MISC	1
Cisneros-area	CITY	MISC	1
Cisneros-registered	CITY	MISC	1
Clark-headquartered	CITY	MISC	1
Clark-owned	CITY	MISC	1
Clark-controlled	CITY	MISC	1
Clark-raised	CITY	MISC	1
Clark-educated	CITY	MISC	1
Clark-backed	CITY	MISC	1
Clark-trained	CITY	MISC	1
Clark-born	CITY	MISC	1
Clark-area	CITY	MISC	1
Clark-registered	CITY	MISC	1
Clayton-headquartered	CITY	MISC	1
Clayton-owned	CITY	MISC	1
Clayton-controlled	CITY	MISC	1
Clayton-raised	CITY	MISC	1
Clayton-educated	CITY	MISC	1
Clayton-backed	CITY	MISC	1
Clayton-trained	CITY	MISC	1
Clayton-born	CITY	MISC	1
Clayton-area	CITY	MISC	1
Clayton-registered	CITY	MISC	1
Colon-headquartered	CITY	MISC	1
Colon-owned	CITY	MISC	1
Colon-controlled	CITY	MISC	1
Colon-raised	CITY	MISC	1
Colon-educated	CITY	MISC	1
Colon-backed	CITY	MISC	1
Colon-trained	CITY	MISC	1
Colon-born	CITY	MISC	1
Colon-area	CITY	MISC	1
Colon-registered	CITY	MISC	1
Compton-headquartered	CITY	MISC	1
Compton-owned	CITY	MISC	1
Compton-controlled	CITY	MISC	1
Compton-raised	CITY	MISC	1
Compton-educated	CITY	MISC	1
Compton-backed	CITY	MISC	1
Compton-trained	CITY	MISC	1
Compton-born	CITY	MISC	1
Compton-area	CITY	MISC	1
Compton-registered	CITY	MISC	1
Conner-headquartered	CITY	MISC	1
Conner-owned	CITY	MISC	1
Conner-controlled	CITY	MISC	1
Conner-raised	CITY	MISC	1
Conner-educated	CITY	MISC	1
Conner-backed	CITY	MISC	1
Conner-trained	CITY	MISC	1
Conner-born	CITY	MISC	1
Conner-area	CITY	MISC	1
Conner-registered	CITY	MISC	1
Conway-headquartered	CITY	MISC	1
Conway-owned	CITY	MISC	1
Conway-controlled	CITY	MISC	1
Conway-raised	CITY	MISC	1
Conway-educated	CITY	MISC	1
Conway-backed	CITY	MISC	1
Conway-trained	CITY	MISC	1
Conway-born	CITY	MISC	1
Conway-area	CITY	MISC	1
Conway-registered	CITY	MISC	1
Cordova-headquartered	CITY	MISC	1
Cordova-owned	CITY	MISC	1
Cordova-controlled	CITY	MISC	1
Cordova-raised	CITY	MISC	1
Cordova-educated	CITY	MISC	1
Cordova-backed	CITY	MISC	1
Cordova-trained	CITY	MISC	1
Cordova-born	CITY	MISC	1
Cordova-area	CITY	MISC	1
Cordova-registered	CITY	MISC	1
Cortez-headquartered	CITY	MISC	1
Cortez-owned	CITY	MISC	1
Cortez-controlled	CITY	MISC	1
Cortez-raised	CITY	MISC	1
Cortez-educated	CITY	MISC	1
Cortez-backed	CITY	MISC	1
Cortez-trained	CITY	MISC	1
Cortez-born	CITY	MISC	1
Cortez-area	CITY	MISC	1
Cortez-registered	CITY	MISC	1
Craig-headquartered	CITY	MISC	1
Craig-owned	CITY	MISC	1
Craig-controlled	CITY	MISC	1
Craig-raised	CITY	MISC	1
Craig-educated	CITY	MISC	1
Craig-backed	CITY	MISC	1
Craig-trained	CITY	MISC	1
Craig-born	CITY	MISC	1
Craig-area	CITY	MISC	1
Craig-registered	CITY	MISC	1
Crosby-headquartered	CITY	MISC	1
Crosby-owned	CITY	MISC	1
Crosby-controlled	CITY	MISC	1
Crosby-raised	CITY	MISC	1
Crosby-educated	CITY	MISC	1
Crosby-backed	CITY	MISC	1
Crosby-trained	CITY	MISC	1
Crosby-born	CITY	MISC	1
Crosby-area	CITY	MISC	1
Crosby-registered	CITY	MISC	1
Cruz-headquartered	CITY	MISC	1
Cruz-owned	CITY	MISC	1
Cruz-controlled	CITY	MISC	1
Cruz-raised	CITY	MISC	1
Cruz-educated	CITY	MISC	1
Cruz-backed	CITY	MISC	1
Cruz-trained	CITY	MISC	1
Cruz-born	CITY	MISC	1
Cruz-area	CITY	MISC	1
Cruz-registered	CITY	MISC	1
Cuevas-headquartered	CITY	MISC	1
Cuevas-owned	CITY	MISC	1
Cuevas-controlled	CITY	MISC	1
Cuevas-raised	CITY	MISC	1
Cuevas-educated	CITY	MISC	1
Cuevas-backed	CITY	MISC	1
Cuevas-trained	CITY	MISC	1
Cuevas-born	CITY	MISC	1
Cuevas-area	CITY	MISC	1
Cuevas-registered	CITY	MISC	1
Curry-headquartered	CITY	MISC	1
Curry-owned	CITY	MISC	1
Curry-controlled	CITY	MISC	1
Curry-raised	CITY	MISC	1
Curry-educated	CITY	MISC	1
Curry-backed	CITY	MISC	1
Curry-trained	CITY	MISC	1
Curry-born	CITY	MISC	1
Curry-area	CITY	MISC	1
Curry-registered	CITY	MISC	1
Dalton-headquartered	CITY	MISC	1
Dalton-owned	CITY	MISC	1
Dalton-controlled	CITY	MISC	1
Dalton-raised	CITY	MISC	1
Dalton-educated	CITY	MISC	1
Dalton-backed	CITY	MISC	1
Dalton-trained	CITY	MISC	1
Dalton-born	CITY	MISC	1
Dalton-area	CITY	MISC	1
Dalton-registered	CITY	MISC	1
Davenport-headquartered	CITY	MISC	1
Davenport-owned	CITY	MISC	1
Davenport-controlled	CITY	MISC	1
Davenport-raised	CITY	MISC	1
Davenport-educated	CITY	MISC	1
Davenport-backed	CITY	MISC	1
Davenport-trained	CITY	MISC	1
Davenport-born	CITY	MISC	1
Davenport-area	CITY	MISC	1
Davenport-registered	CITY	MISC	1
David-headquartered	CITY	MISC	1
David-owned	CITY	MISC	1
David-controlled	CITY	MISC	1
David-raised	CITY	MISC	1
David-educated	CITY	MISC	1
David-backed	CITY	MISC	1
David-trained	CITY	MISC	1
David-born	CITY	MISC	1
David-area	CITY	MISC	1
David-registered	CITY	MISC	1
Davidson-headquartered	CITY	MISC	1
Davidson-owned	CITY	MISC	1
Davidson-controlled	CITY	MISC	1
Davidson-raised	CITY	MISC	1
Davidson-educated	CITY	MISC	1
Davidson-backed	CITY	MISC	1
Davidson-trained	CITY	MISC	1
Davidson-born	CITY	MISC	1
Davidson-area	CITY	MISC	1
Davidson-registered	CITY	MISC	1
Davila-headquartered	CITY	MISC	1
Davila-owned	CITY	MISC	1
Davila-controlled	CITY	MISC	1
Davila-raised	CITY	MISC	1
Davila-educated	CITY	MISC	1
Davila-backed	CITY	MISC	1
Davila-trained	CITY	MISC	1
Davila-born	CITY	MISC	1
Davila-area	CITY	MISC	1
Davila-registered	CITY	MISC	1
Davis-headquartered	CITY	MISC	1
Davis-owned	CITY	MISC	1
Davis-controlled	CITY	MISC	1
Davis-raised	CITY	MISC	1
Davis-educated	CITY	MISC	1
Davis-backed	CITY	MISC	1
Davis-trained	CITY	MISC	1
Davis-born	CITY	MISC	1
Davis-area	CITY	MISC	1
Davis-registered	CITY	MISC	1
Dawson-headquartered	CITY	MISC	1
Dawson-owned	CITY	MISC	1
Dawson-controlled	CITY	MISC	1
Dawson-raised	CITY	MISC	1
Dawson-educated	CITY	MISC	1
Dawson-backed	CITY	MISC	1
Dawson-trained	CITY	MISC	1
Dawson-born	CITY	MISC	1
Dawson-area	CITY	MISC	1
Dawson-registered	CITY	MISC	1
Delgado-headquartered	CITY	MISC	1
Delgado-owned	CITY	MISC	1
Delgado-controlled	CITY	MISC	1
Delgado-raised	CITY	MISC	1
Delgado-educated	CITY	MISC	1
Delgado-backed	CITY	MISC	1
Delgado-trained	CITY	MISC	1
Delgado-born	CITY	MISC	1
Delgado-area	CITY	MISC	1
Delgado-registered	CITY	MISC	1
Dennis-headquartered	CITY	MISC	1
Dennis-owned	CITY	MISC	1
Dennis-controlled	CITY	MISC	1
Dennis-raised	CITY	MISC	1
Dennis-educated	CITY	MISC	1
Dennis-backed	CITY	MISC	1
Dennis-trained	CITY	MISC	1
Dennis-born	CITY	MISC	1
Dennis-area	CITY	MISC	1
Dennis-registered	CITY	MISC	1
Diaz-headquartered	CITY	MISC	1
Diaz-owned	CITY	MISC	1
Diaz-controlled	CITY	MISC	1
Diaz-raised	CITY	MISC	1
Diaz-educated	CITY	MISC	1
Diaz-backed	CITY	MISC	1
Diaz-trained	CITY	MISC	1
Diaz-born	CITY	MISC	1
Diaz-area	CITY	MISC	1
Diaz-registered	CITY	MISC	1
Dickson-headquartered	CITY	MISC	1
Dickson-owned	CITY	MISC	1
Dickson-controlled	CITY	MISC	1
Dickson-raised	CITY	MISC	1
Dickson-educated	CITY	MISC	1
Dickson-backed	CITY	MISC	1
Dickson-trained	CITY	MISC	1
Dickson-born	CITY	MISC	1
Dickson-area	CITY	MISC	1
Dickson-registered	CITY	MISC	1
Dillon-headquartered	CITY	MISC	1
Dillon-owned	CITY	MISC	1
Dillon-controlled	CITY	MISC	1
Dillon-raised	CITY	MISC	1
Dillon-educated	CITY	MISC	1
Dillon-backed	CITY	MISC	1
Dillon-trained	CITY	MISC	1
Dillon-born	CITY	MISC	1
Dillon-area	CITY	MISC	1
Dillon-registered	CITY	MISC	1
Dixon-headquartered	CITY	MISC	1
Dixon-owned	CITY	MISC	1
Dixon-controlled	CITY	MISC	1
Dixon-raised	CITY	MISC	1
Dixon-educated	CITY	MISC	1
Dixon-backed	CITY	MISC	1
Dixon-trained	CITY	MISC	1
Dixon-born	CITY	MISC	1
Dixon-area	CITY	MISC	1
Dixon-registered	CITY	MISC	1
Douglas-headquartered	CITY	MISC	1
Douglas-owned	CITY	MISC	1
Douglas-controlled	CITY	MISC	1
Douglas-raised	CITY	MISC	1
Douglas-educated	CITY	MISC	1
Douglas-backed	CITY	MISC	1
Douglas-trained	CITY	MISC	1
Douglas-born	CITY	MISC	1
Douglas-area	CITY	MISC	1
Douglas-registered	CITY	MISC	1
Duarte-headquartered	CITY	MISC	1
Duarte-owned	CITY	MISC	1
Duarte-controlled	CITY	MISC	1
Duarte-raised	CITY	MISC	1
Duarte-educated	CITY	MISC	1
Duarte-backed	CITY	MISC	1
Duarte-trained	CITY	MISC	1
Duarte-born	CITY	MISC	1
Duarte-area	CITY	MISC	1
Duarte-registered	CITY	MISC	1
Dudley-headquartered	CITY	MISC	1
Dudley-owned	CITY	MISC	1
Dudley-controlled	CITY	MISC	1
Dudley-raised	CITY	MISC	1
Dudley-educated	CITY	MISC	1
Dudley-backed	CITY	MISC	1
Dudley-trained	CITY	MISC	1
Dudley-born	CITY	MISC	1
Dudley-area	CITY	MISC	1
Dudley-registered	CITY	MISC	1
Duncan-headquartered	CITY	MISC	1
Duncan-owned	CITY	MISC	1
Duncan-controlled	CITY	MISC	1
Duncan-raised	CITY	MISC	1
Duncan-educated	CITY	MISC	1
Duncan-backed	CITY	MISC	1
Duncan-trained	CITY	MISC	1
Duncan-born	CITY	MISC	1
Duncan-area	CITY	MISC	1
Duncan-registered	CITY	MISC	1
Dunn-headquartered	CITY	MISC	1
Dunn-owned	CITY	MISC	1
Dunn-controlled	CITY	MISC	1
Dunn-raised	CITY	MISC	1
Dunn-educated	CITY	MISC	1
Dunn-backed	CITY	MISC	1
Dunn-trained	CITY	MISC	1
Dunn-born	CITY	MISC	1
Dunn-area	CITY	MISC	1
Dunn-registered	CITY	MISC	1
Duran-headquartered	CITY	MISC	1
Duran-owned	CITY	MISC	1
Duran-controlled	CITY	MISC	1
Duran-raised	CITY	MISC	1
Duran-educated	CITY	MISC	1
Duran-backed	CITY	MISC	1
Duran-trained	CITY	MISC	1
Duran-born	CITY	MISC	1
Duran-area	CITY	MISC	1
Duran-registered	CITY	MISC	1
Durham-headquartered	CITY	MISC	1
Durham-owned	CITY	MISC	1
Durham-controlled	CITY	MISC	1
Durham-raised	CITY	MISC	1
Durham-educated	CITY	MISC	1
Durham-backed	CITY	MISC	1
Durham-trained	CITY	MISC	1
Durham-born	CITY	MISC	1
Durham-area	CITY	MISC	1
Durham-registered	CITY	MISC	1
Dyer-headquartered	CITY	MISC	1
Dyer-owned	CITY	MISC	1
Dyer-controlled	CITY	MISC	1
Dyer-raised	CITY	MISC	1
Dyer-educated	CITY	MISC	1
Dyer-backed	CITY	MISC	1
Dyer-trained	CITY	MISC	1
Dyer-born	CITY	MISC	1
Dyer-area	CITY	MISC	1
Dyer-registered	CITY	MISC	1
Escobar-headquartered	CITY	MISC	1
Escobar-owned	CITY	MISC	1
Escobar-controlled	CITY	MISC	1
Escobar-raised	CITY	MISC	1
Escobar-educated	CITY	MISC	1
Escobar-backed	CITY	MISC	1
Escobar-trained	CITY	MISC	1
Escobar-born	CITY	MISC	1
Escobar-area	CITY	MISC	1
Escobar-registered	CITY	MISC	1
Evans-headquartered	CITY	MISC	1
Evans-owned	CITY	MISC	1
Evans-controlled	CITY	MISC	1
Evans-raised	CITY	MISC	1
Evans-educated	CITY	MISC	1
Evans-backed	CITY	MISC	1
Evans-trained	CITY	MISC	1
Evans-born	CITY	MISC	1
Evans-area	CITY	MISC	1
Evans-registered	CITY	MISC	1
Everett-headquartered	CITY	MISC	1
Everett-owned	CITY	MISC	1
Everett-controlled	CITY	MISC	1
Everett-raised	CITY	MISC	1
Everett-educated	CITY	MISC	1
Everett-backed	CITY	MISC	1
Everett-trained	CITY	MISC	1
Everett-born	CITY	MISC	1
Everett-area	CITY	MISC	1
Everett-registered	CITY	MISC	1
Ewing-headquartered	CITY	MISC	1
Ewing-owned	CITY	MISC	1
Ewing-controlled	CITY	MISC	1
Ewing-raised	CITY	MISC	1
Ewing-educated	CITY	MISC	1
Ewing-backed	CITY	MISC	1
Ewing-trained	CITY	MISC	1
Ewing-born	CITY	MISC	1
Ewing-area	CITY	MISC	1
Ewing-registered	CITY	MISC	1
Ferguson-headquartered	CITY	MISC	1
Ferguson-owned	CITY	MISC	1
Ferguson-controlled	CITY	MISC	1
Ferguson-raised	CITY	MISC	1
Ferguson-educated	CITY	MISC	1
Ferguson-backed	CITY	MISC	1
Ferguson-trained	CITY	MISC	1
Ferguson-born	CITY	MISC	1
Ferguson-area	CITY	MISC	1
Ferguson-registered	CITY	MISC	1
Fernandez-headquartered	CITY	MISC	1
Fernandez-owned	CITY	MISC	1
Fernandez-controlled	CITY	MISC	1
Fernandez-raised	CITY	MISC	1
Fernandez-educated	CITY	MISC	1
Fernandez-backed	CITY	MISC	1
Fernandez-trained	CITY	MISC	1
Fernandez-born	CITY	MISC	1
Fernandez-area	CITY	MISC	1
Fernandez-registered	CITY	MISC	1
Flores-headquartered	CITY	MISC	1
Flores-owned	CITY	MISC	1
Flores-controlled	CITY	MISC	1
Flores-raised	CITY	MISC	1
Flores-educated	CITY	MISC	1
Flores-backed	CITY	MISC	1
Flores-trained	CITY	MISC	1
Flores-born	CITY	MISC	1
Flores-area	CITY	MISC	1
Flores-registered	CITY	MISC	1
Forbes-headquartered	CITY	MISC	1
Forbes-owned	CITY	MISC	1
Forbes-controlled	CITY	MISC	1
Forbes-raised	CITY	MISC	1
Forbes-educated	CITY	MISC	1
Forbes-backed	CITY	MISC	1
Forbes-trained	CITY	MISC	1
Forbes-born	CITY	MISC	1
Forbes-area	CITY	MISC	1
Forbes-registered	CITY	MISC	1
Foster-headquartered	CITY	MISC	1
Foster-owned	CITY	MISC	1
Foster-controlled	CITY	MISC	1
Foster-raised	CITY	MISC	1
Foster-educated	CITY	MISC	1
Foster-backed	CITY	MISC	1
Foster-trained	CITY	MISC	1
Foster-born	CITY	MISC	1
Foster-area	CITY	MISC	1
Foster-registered	CITY	MISC	1
Franklin-headquartered	CITY	MISC	1
Franklin-owned	CITY	MISC	1
Franklin-controlled	CITY	MISC	1
Franklin-raised	CITY	MISC	1
Franklin-educated	CITY	MISC	1
Franklin-backed	CITY	MISC	1
Franklin-trained	CITY	MISC	1
Franklin-born	CITY	MISC	1
Franklin-area	CITY	MISC	1
Franklin-registered	CITY	MISC	1
Frederick-headquartered	CITY	MISC	1
Frederick-owned	CITY	MISC	1
Frederick-controlled	CITY	MISC	1
Frederick-raised	CITY	MISC	1
Frederick-educated	CITY	MISC	1
Frederick-backed	CITY	MISC	1
Frederick-trained	CITY	MISC	1
Frederick-born	CITY	MISC	1
Frederick-area	CITY	MISC	1
Frederick-registered	CITY	MISC	1
Garcia-headquartered	CITY	MISC	1
Garcia-owned	CITY	MISC	1
Garcia-controlled	CITY	MISC	1
Garcia-raised	CITY	MISC	1
Garcia-educated	CITY	MISC	1
Garcia-backed	CITY	MISC	1
Garcia-trained	CITY	MISC	1
Garcia-born	CITY	MISC	1
Garcia-area	CITY	MISC	1
Garcia-registered	CITY	MISC	1
Gardner-headquartered	CITY	MISC	1
Gardner-owned	CITY	MISC	1
Gardner-controlled	CITY	MISC	1
Gardner-raised	CITY	MISC	1
Gardner-educated	CITY	MISC	1
Gardner-backed	CITY	MISC	1
Gardner-trained	CITY	MISC	1
Gardner-born	CITY	MISC	1
Gardner-area	CITY	MISC	1
Gardner-registered	CITY	MISC	1
Garner-headquartered	CITY	MISC	1
Garner-owned	CITY	MISC	1
Garner-controlled	CITY	MISC	1
Garner-raised	CITY	MISC	1
Garner-educated	CITY	MISC	1
Garner-backed	CITY	MISC	1
Garner-trained	CITY	MISC	1
Garner-born	CITY	MISC	1
Garner-area	CITY	MISC	1
Garner-registered	CITY	MISC	1
Gay-headquartered	CITY	MISC	1
Gay-owned	CITY	MISC	1
Gay-controlled	CITY	MISC	1
Gay-raised	CITY	MISC	1
Gay-educated	CITY	MISC	1
Gay-backed	CITY	MISC	1
Gay-trained	CITY	MISC	1
Gay-born	CITY	MISC	1
Gay-area	CITY	MISC	1
Gay-registered	CITY	MISC	1
George-headquartered	CITY	MISC	1
George-owned	CITY	MISC	1
George-controlled	CITY	MISC	1
George-raised	CITY	MISC	1
George-educated	CITY	MISC	1
George-backed	CITY	MISC	1
George-trained	CITY	MISC	1
George-born	CITY	MISC	1
George-area	CITY	MISC	1
George-registered	CITY	MISC	1
Gilbert-headquartered	CITY	MISC	1
Gilbert-owned	CITY	MISC	1
Gilbert-controlled	CITY	MISC	1
Gilbert-raised	CITY	MISC	1
Gilbert-educated	CITY	MISC	1
Gilbert-backed	CITY	MISC	1
Gilbert-trained	CITY	MISC	1
Gilbert-born	CITY	MISC	1
Gilbert-area	CITY	MISC	1
Gilbert-registered	CITY	MISC	1
Golden-headquartered	CITY	MISC	1
Golden-owned	CITY	MISC	1
Golden-controlled	CITY	MISC	1
Golden-raised	CITY	MISC	1
Golden-educated	CITY	MISC	1
Golden-backed	CITY	MISC	1
Golden-trained	CITY	MISC	1
Golden-born	CITY	MISC	1
Golden-area	CITY	MISC	1
Golden-registered	CITY	MISC	1
Gomez-headquartered	CITY	MISC	1
Gomez-owned	CITY	MISC	1
Gomez-controlled	CITY	MISC	1
Gomez-raised	CITY	MISC	1
Gomez-educated	CITY	MISC	1
Gomez-backed	CITY	MISC	1
Gomez-trained	CITY	MISC	1
Gomez-born	CITY	MISC	1
Gomez-area	CITY	MISC	1
Gomez-registered	CITY	MISC	1
Gonzales-headquartered	CITY	MISC	1
Gonzales-owned	CITY	MISC	1
Gonzales-controlled	CITY	MISC	1
Gonzales-raised	CITY	MISC	1
Gonzales-educated	CITY	MISC	1
Gonzales-backed	CITY	MISC	1
Gonzales-trained	CITY	MISC	1
Gonzales-born	CITY	MISC	1
Gonzales-area	CITY	MISC	1
Gonzales-registered	CITY	MISC	1
Gonzalez-headquartered	CITY	MISC	1
Gonzalez-owned	CITY	MISC	1
Gonzalez-controlled	CITY	MISC	1
Gonzalez-raised	CITY	MISC	1
Gonzalez-educated	CITY	MISC	1
Gonzalez-backed	CITY	MISC	1
Gonzalez-trained	CITY	MISC	1
Gonzalez-born	CITY	MISC	1
Gonzalez-area	CITY	MISC	1
Gonzalez-registered	CITY	MISC	1
Graham-headquartered	CITY	MISC	1
Graham-owned	CITY	MISC	1
Graham-controlled	CITY	MISC	1
Graham-raised	CITY	MISC	1
Graham-educated	CITY	MISC	1
Graham-backed	CITY	MISC	1
Graham-trained	CITY	MISC	1
Graham-born	CITY	MISC	1
Graham-area	CITY	MISC	1
Graham-registered	CITY	MISC	1
Gray-headquartered	CITY	MISC	1
Gray-owned	CITY	MISC	1
Gray-controlled	CITY	MISC	1
Gray-raised	CITY	MISC	1
Gray-educated	CITY	MISC	1
Gray-backed	CITY	MISC	1
Gray-trained	CITY	MISC	1
Gray-born	CITY	MISC	1
Gray-area	CITY	MISC	1
Gray-registered	CITY	MISC	1
Green-headquartered	CITY	MISC	1
Green-owned	CITY	MISC	1
Green-controlled	CITY	MISC	1
Green-raised	CITY	MISC	1
Green-educated	CITY	MISC	1
Green-backed	CITY	MISC	1
Green-trained	CITY	MISC	1
Green-born	CITY	MISC	1
Green-area	CITY	MISC	1
Green-registered	CITY	MISC	1
Greer-headquartered	CITY	MISC	1
Greer-owned	CITY	MISC	1
Greer-controlled	CITY	MISC	1
Greer-raised	CITY	MISC	1
Greer-educated	CITY	MISC	1
Greer-backed	CITY	MISC	1
Greer-trained	CITY	MISC	1
Greer-born	CITY	MISC	1
Greer-area	CITY	MISC	1
Greer-registered	CITY	MISC	1
Griffin-headquartered	CITY	MISC	1
Griffin-owned	CITY	MISC	1
Griffin-controlled	CITY	MISC	1
Griffin-raised	CITY	MISC	1
Griffin-educated	CITY	MISC	1
Griffin-backed	CITY	MISC	1
Griffin-trained	CITY	MISC	1
Griffin-born	CITY	MISC	1
Griffin-area	CITY	MISC	1
Griffin-registered	CITY	MISC	1
Griffith-headquartered	CITY	MISC	1
Griffith-owned	CITY	MISC	1
Griffith-controlled	CITY	MISC	1
Griffith-raised	CITY	MISC	1
Griffith-educated	CITY	MISC	1
Griffith-backed	CITY	MISC	1
Griffith-trained	CITY	MISC	1
Griffith-born	CITY	MISC	1
Griffith-area	CITY	MISC	1
Griffith-registered	CITY	MISC	1
Guerrero-headquartered	CITY	MISC	1
Guerrero-owned	CITY	MISC	1
Guerrero-controlled	CITY	MISC	1
Guerrero-raised	CITY	MISC	1
Guerrero-educated	CITY	MISC	1
Guerrero-backed	CITY	MISC	1
Guerrero-trained	CITY	MISC	1
Guerrero-born	CITY	MISC	1
Guerrero-area	CITY	MISC	1
Guerrero-registered	CITY	MISC	1
Gutierrez-headquartered	CITY	MISC	1
Gutierrez-owned	CITY	MISC	1
Gutierrez-controlled	CITY	MISC	1
Gutierrez-raised	CITY	MISC	1
Gutierrez-educated	CITY	MISC	1
Gutierrez-backed	CITY	MISC	1
Gutierrez-trained	CITY	MISC	1
Gutierrez-born	CITY	MISC	1
Gutierrez-area	CITY	MISC	1
Gutierrez-registered	CITY	MISC	1
Hamilton-headquartered	CITY	MISC	1
Hamilton-owned	CITY	MISC	1
Hamilton-controlled	CITY	MISC	1
Hamilton-raised	CITY	MISC	1
Hamilton-educated	CITY	MISC	1
Hamilton-backed	CITY	MISC	1
Hamilton-trained	CITY	MISC	1
Hamilton-born	CITY	MISC	1
Hamilton-area	CITY	MISC	1
Hamilton-registered	CITY	MISC	1
Hammond-headquartered	CITY	MISC	1
Hammond-owned	CITY	MISC	1
Hammond-controlled	CITY	MISC	1
Hammond-raised	CITY	MISC	1
Hammond-educated	CITY	MISC	1
Hammond-backed	CITY	MISC	1
Hammond-trained	CITY	MISC	1
Hammond-born	CITY	MISC	1
Hammond-area	CITY	MISC	1
Hammond-registered	CITY	MISC	1
Hampton-headquartered	CITY	MISC	1
Hampton-owned	CITY	MISC	1
Hampton-controlled	CITY	MISC	1
Hampton-raised	CITY	MISC	1
Hampton-educated	CITY	MISC	1
Hampton-backed	CITY	MISC	1
Hampton-trained	CITY	MISC	1
Hampton-born	CITY	MISC	1
Hampton-area	CITY	MISC	1
Hampton-registered	CITY	MISC	1
Hanna-headquartered	CITY	MISC	1
Hanna-owned	CITY	MISC	1
Hanna-controlled	CITY	MISC	1
Hanna-raised	CITY	MISC	1
Hanna-educated	CITY	MISC	1
Hanna-backed	CITY	MISC	1
Hanna-trained	CITY	MISC	1
Hanna-born	CITY	MISC	1
Hanna-area	CITY	MISC	1
Hanna-registered	CITY	MISC	1
Hanson-headquartered	CITY	MISC	1
Hanson-owned	CITY	MISC	1
Hanson-controlled	CITY	MISC	1
Hanson-raised	CITY	MISC	1
Hanson-educated	CITY	MISC	1
Hanson-backed	CITY	MISC	1
Hanson-trained	CITY	MISC	1
Hanson-born	CITY	MISC	1
Hanson-area	CITY	MISC	1
Hanson-registered	CITY	MISC	1
Harper-headquartered	CITY	MISC	1
Harper-owned	CITY	MISC	1
Harper-controlled	CITY	MISC	1
Harper-raised	CITY	MISC	1
Harper-educated	CITY	MISC	1
Harper-backed	CITY	MISC	1
Harper-trained	CITY	MISC	1
Harper-born	CITY	MISC	1
Harper-area	CITY	MISC	1
Harper-registered	CITY	MISC	1
Harrison-headquartered	CITY	MISC	1
Harrison-owned	CITY	MISC	1
Harrison-controlled	CITY	MISC	1
Harrison-raised	CITY	MISC	1
Harrison-educated	CITY	MISC	1
Harrison-backed	CITY	MISC	1
Harrison-trained	CITY	MISC	1
Harrison-born	CITY	MISC	1
Harrison-area	CITY	MISC	1
Harrison-registered	CITY	MISC	1
Harvey-headquartered	CITY	MISC	1
Harvey-owned	CITY	MISC	1
Harvey-controlled	CITY	MISC	1
Harvey-raised	CITY	MISC	1
Harvey-educated	CITY	MISC	1
Harvey-backed	CITY	MISC	1
Harvey-trained	CITY	MISC	1
Harvey-born	CITY	MISC	1
Harvey-area	CITY	MISC	1
Harvey-registered	CITY	MISC	1
Hatfield-headquartered	CITY	MISC	1
Hatfield-owned	CITY	MISC	1
Hatfield-controlled	CITY	MISC	1
Hatfield-raised	CITY	MISC	1
Hatfield-educated	CITY	MISC	1
Hatfield-backed	CITY	MISC	1
Hatfield-trained	CITY	MISC	1
Hatfield-born	CITY	MISC	1
Hatfield-area	CITY	MISC	1
Hatfield-registered	CITY	MISC	1
Hayden-headquartered	CITY	MISC	1
Hayden-owned	CITY	MISC	1
Hayden-controlled	CITY	MISC	1
Hayden-raised	CITY	MISC	1
Hayden-educated	CITY	MISC	1
Hayden-backed	CITY	MISC	1
Hayden-trained	CITY	MISC	1
Hayden-born	CITY	MISC	1
Hayden-area	CITY	MISC	1
Hayden-registered	CITY	MISC	1
Hays-headquartered	CITY	MISC	1
Hays-owned	CITY	MISC	1
Hays-controlled	CITY	MISC	1
Hays-raised	CITY	MISC	1
Hays-educated	CITY	MISC	1
Hays-backed	CITY	MISC	1
Hays-trained	CITY	MISC	1
Hays-born	CITY	MISC	1
Hays-area	CITY	MISC	1
Hays-registered	CITY	MISC	1
Henderson-headquartered	CITY	MISC	1
Henderson-owned	CITY	MISC	1
Henderson-controlled	CITY	MISC	1
Henderson-raised	CITY	MISC	1
Henderson-educated	CITY	MISC	1
Henderson-backed	CITY	MISC	1
Henderson-trained	CITY	MISC	1
Henderson-born	CITY	MISC	1
Henderson-area	CITY	MISC	1
Henderson-registered	CITY	MISC	1
Herrera-headquartered	CITY	MISC	1
Herrera-owned	CITY	MISC	1
Herrera-controlled	CITY	MISC	1
Herrera-raised	CITY	MISC	1
Herrera-educated	CITY	MISC	1
Herrera-backed	CITY	MISC	1
Herrera-trained	CITY	MISC	1
Herrera-born	CITY	MISC	1
Herrera-area	CITY	MISC	1
Herrera-registered	CITY	MISC	1
Hinton-headquartered	CITY	MISC	1
Hinton-owned	CITY	MISC	1
Hinton-controlled	CITY	MISC	1
Hinton-raised	CITY	MISC	1
Hinton-educated	CITY	MISC	1
Hinton-backed	CITY	MISC	1
Hinton-trained	CITY	MISC	1
Hinton-born	CITY	MISC	1
Hinton-area	CITY	MISC	1
Hinton-registered	CITY	MISC	1
Ho-headquartered	CITY	MISC	1
Ho-owned	CITY	MISC	1
Ho-controlled	CITY	MISC	1
Ho-raised	CITY	MISC	1
Ho-educated	CITY	MISC	1
Ho-backed	CITY	MISC	1
Ho-trained	CITY	MISC	1
Ho-born	CITY	MISC	1
Ho-area	CITY	MISC	1
Ho-registered	CITY	MISC	1
Hobbs-headquartered	CITY	MISC	1
Hobbs-owned	CITY	MISC	1
Hobbs-controlled	CITY	MISC	1
Hobbs-raised	CITY	MISC	1
Hobbs-educated	CITY	MISC	1
Hobbs-backed	CITY	MISC	1
Hobbs-trained	CITY	MISC	1
Hobbs-born	CITY	MISC	1
Hobbs-area	CITY	MISC	1
Hobbs-registered	CITY	MISC	1
Holden-headquartered	CITY	MISC	1
Holden-owned	CITY	MISC	1
Holden-controlled	CITY	MISC	1
Holden-raised	CITY	MISC	1
Holden-educated	CITY	MISC	1
Holden-backed	CITY	MISC	1
Holden-trained	CITY	MISC	1
Holden-born	CITY	MISC	1
Holden-area	CITY	MISC	1
Holden-registered	CITY	MISC	1
Holland-headquartered	CITY	MISC	1
Holland-owned	CITY	MISC	1
Holland-controlled	CITY	MISC	1
Holland-raised	CITY	MISC	1
Holland-educated	CITY	MISC	1
Holland-backed	CITY	MISC	1
Holland-trained	CITY	MISC	1
Holland-born	CITY	MISC	1
Holland-area	CITY	MISC	1
Holland-registered	CITY	MISC	1
Holt-headquartered	CITY	MISC	1
Holt-owned	CITY	MISC	1
Holt-controlled	CITY	MISC	1
Holt-raised	CITY	MISC	1
Holt-educated	CITY	MISC	1
Holt-backed	CITY	MISC	1
Holt-trained	CITY	MISC	1
Holt-born	CITY	MISC	1
Holt-area	CITY	MISC	1
Holt-registered	CITY	MISC	1
Hoover-headquartered	CITY	MISC	1
Hoover-owned	CITY	MISC	1
Hoover-controlled	CITY	MISC	1
Hoover-raised	CITY	MISC	1
Hoover-educated	CITY	MISC	1
Hoover-backed	CITY	MISC	1
Hoover-trained	CITY	MISC	1
Hoover-born	CITY	MISC	1
Hoover-area	CITY	MISC	1
Hoover-registered	CITY	MISC	1
Hopkins-headquartered	CITY	MISC	1
Hopkins-owned	CITY	MISC	1
Hopkins-controlled	CITY	MISC	1
Hopkins-raised	CITY	MISC	1
Hopkins-educated	CITY	MISC	1
Hopkins-backed	CITY	MISC	1
Hopkins-trained	CITY	MISC	1
Hopkins-born	CITY	MISC	1
Hopkins-area	CITY	MISC	1
Hopkins-registered	CITY	MISC	1
Horn-headquartered	CITY	MISC	1
Horn-owned	CITY	MISC	1
Horn-controlled	CITY	MISC	1
Horn-raised	CITY	MISC	1
Horn-educated	CITY	MISC	1
Horn-backed	CITY	MISC	1
Horn-trained	CITY	MISC	1
Horn-born	CITY	MISC	1
Horn-area	CITY	MISC	1
Horn-registered	CITY	MISC	1
Houston-headquartered	CITY	MISC	1
Houston-owned	CITY	MISC	1
Houston-controlled	CITY	MISC	1
Houston-raised	CITY	MISC	1
Houston-educated	CITY	MISC	1
Houston-backed	CITY	MISC	1
Houston-trained	CITY	MISC	1
Houston-born	CITY	MISC	1
Houston-area	CITY	MISC	1
Houston-registered	CITY	MISC	1
Howard-headquartered	CITY	MISC	1
Howard-owned	CITY	MISC	1
Howard-controlled	CITY	MISC	1
Howard-raised	CITY	MISC	1
Howard-educated	CITY	MISC	1
Howard-backed	CITY	MISC	1
Howard-trained	CITY	MISC	1
Howard-born	CITY	MISC	1
Howard-area	CITY	MISC	1
Howard-registered	CITY	MISC	1
Howell-headquartered	CITY	MISC	1
Howell-owned	CITY	MISC	1
Howell-controlled	CITY	MISC	1
Howell-raised	CITY	MISC	1
Howell-educated	CITY	MISC	1
Howell-backed	CITY	MISC	1
Howell-trained	CITY	MISC	1
Howell-born	CITY	MISC	1
Howell-area	CITY	MISC	1
Howell-registered	CITY	MISC	1
Hudson-headquartered	CITY	MISC	1
Hudson-owned	CITY	MISC	1
Hudson-controlled	CITY	MISC	1
Hudson-raised	CITY	MISC	1
Hudson-educated	CITY	MISC	1
Hudson-backed	CITY	MISC	1
Hudson-trained	CITY	MISC	1
Hudson-born	CITY	MISC	1
Hudson-area	CITY	MISC	1
Hudson-registered	CITY	MISC	1
Hull-headquartered	CITY	MISC	1
Hull-owned	CITY	MISC	1
Hull-controlled	CITY	MISC	1
Hull-raised	CITY	MISC	1
Hull-educated	CITY	MISC	1
Hull-backed	CITY	MISC	1
Hull-trained	CITY	MISC	1
Hull-born	CITY	MISC	1
Hull-area	CITY	MISC	1
Hull-registered	CITY	MISC	1
Hurst-headquartered	CITY	MISC	1
Hurst-owned	CITY	MISC	1
Hurst-controlled	CITY	MISC	1
Hurst-raised	CITY	MISC	1
Hurst-educated	CITY	MISC	1
Hurst-backed	CITY	MISC	1
Hurst-trained	CITY	MISC	1
Hurst-born	CITY	MISC	1
Hurst-area	CITY	MISC	1
Hurst-registered	CITY	MISC	1
Hutchinson-headquartered	CITY	MISC	1
Hutchinson-owned	CITY	MISC	1
Hutchinson-controlled	CITY	MISC	1
Hutchinson-raised	CITY	MISC	1
Hutchinson-educated	CITY	MISC	1
Hutchinson-backed	CITY	MISC	1
Hutchinson-trained	CITY	MISC	1
Hutchinson-born	CITY	MISC	1
Hutchinson-area	CITY	MISC	1
Hutchinson-registered	CITY	MISC	1
Ibarra-headquartered	CITY	MISC	1
Ibarra-owned	CITY	MISC	1
Ibarra-controlled	CITY	MISC	1
Ibarra-raised	CITY	MISC	1
Ibarra-educated	CITY	MISC	1
Ibarra-backed	CITY	MISC	1
Ibarra-trained	CITY	MISC	1
Ibarra-born	CITY	MISC	1
Ibarra-area	CITY	MISC	1
Ibarra-registered	CITY	MISC	1
Jackson-headquartered	CITY	MISC	1
Jackson-owned	CITY	MISC	1
Jackson-controlled	CITY	MISC	1
Jackson-raised	CITY	MISC	1
Jackson-educated	CITY	MISC	1
Jackson-backed	CITY	MISC	1
Jackson-trained	CITY	MISC	1
Jackson-born	CITY	MISC	1
Jackson-area	CITY	MISC	1
Jackson-registered	CITY	MISC	1
Jefferson-headquartered	CITY	MISC	1
Jefferson-owned	CITY	MISC	1
Jefferson-controlled	CITY	MISC	1
Jefferson-raised	CITY	MISC	1
Jefferson-educated	CITY	MISC	1
Jefferson-backed	CITY	MISC	1
Jefferson-trained	CITY	MISC	1
Jefferson-born	CITY	MISC	1
Jefferson-area	CITY	MISC	1
Jefferson-registered	CITY	MISC	1
Jennings-headquartered	CITY	MISC	1
Jennings-owned	CITY	MISC	1
Jennings-controlled	CITY	MISC	1
Jennings-raised	CITY	MISC	1
Jennings-educated	CITY	MISC	1
Jennings-backed	CITY	MISC	1
Jennings-trained	CITY	MISC	1
Jennings-born	CITY	MISC	1
Jennings-area	CITY	MISC	1
Jennings-registered	CITY	MISC	1
Jimenez-headquartered	CITY	MISC	1
Jimenez-owned	CITY	MISC	1
Jimenez-controlled	CITY	MISC	1
Jimenez-raised	CITY	MISC	1
Jimenez-educated	CITY	MISC	1
Jimenez-backed	CITY	MISC	1
Jimenez-trained	CITY	MISC	1
Jimenez-born	CITY	MISC	1
Jimenez-area	CITY	MISC	1
Jimenez-registered	CITY	MISC	1
Johnston-headquartered	CITY	MISC	1
Johnston-owned	CITY	MISC	1
Johnston-controlled	CITY	MISC	1
Johnston-raised	CITY	MISC	1
Johnston-educated	CITY	MISC	1
Johnston-backed	CITY	MISC	1
Johnston-trained	CITY	MISC	1
Johnston-born	CITY	MISC	1
Johnston-area	CITY	MISC	1
Johnston-registered	CITY	MISC	1
Jones-headquartered	CITY	MISC	1
Jones-owned	CITY	MISC	1
Jones-controlled	CITY	MISC	1
Jones-raised	CITY	MISC	1
Jones-educated	CITY	MISC	1
Jones-backed	CITY	MISC	1
Jones-trained	CITY	MISC	1
Jones-born	CITY	MISC	1
Jones-area	CITY	MISC	1
Jones-registered	CITY	MISC	1
Jordan-headquartered	CITY	MISC	1
Jordan-owned	CITY	MISC	1
Jordan-controlled	CITY	MISC	1
Jordan-raised	CITY	MISC	1
Jordan-educated	CITY	MISC	1
Jordan-backed	CITY	MISC	1
Jordan-trained	CITY	MISC	1
Jordan-born	CITY	MISC	1
Jordan-area	CITY	MISC	1
Jordan-registered	CITY	MISC	1
Juarez-headquartered	CITY	MISC	1
Juarez-owned	CITY	MISC	1
Juarez-controlled	CITY	MISC	1
Juarez-raised	CITY	MISC	1
Juarez-educated	CITY	MISC	1
Juarez-backed	CITY	MISC	1
Juarez-trained	CITY	MISC	1
Juarez-born	CITY	MISC	1
Juarez-area	CITY	MISC	1
Juarez-registered	CITY	MISC	1
Keith-headquartered	CITY	MISC	1
Keith-owned	CITY	MISC	1
Keith-controlled	CITY	MISC	1
Keith-raised	CITY	MISC	1
Keith-educated	CITY	MISC	1
Keith-backed	CITY	MISC	1
Keith-trained	CITY	MISC	1
Keith-born	CITY	MISC	1
Keith-area	CITY	MISC	1
Keith-registered	CITY	MISC	1
Keller-headquartered	CITY	MISC	1
Keller-owned	CITY	MISC	1
Keller-controlled	CITY	MISC	1
Keller-raised	CITY	MISC	1
Keller-educated	CITY	MISC	1
Keller-backed	CITY	MISC	1
Keller-trained	CITY	MISC	1
Keller-born	CITY	MISC	1
Keller-area	CITY	MISC	1
Keller-registered	CITY	MISC	1
Kent-headquartered	CITY	MISC	1
Kent-owned	CITY	MISC	1
Kent-controlled	CITY	MISC	1
Kent-raised	CITY	MISC	1
Kent-educated	CITY	MISC	1
Kent-backed	CITY	MISC	1
Kent-trained	CITY	MISC	1
Kent-born	CITY	MISC	1
Kent-area	CITY	MISC	1
Kent-registered	CITY	MISC	1
Kim-headquartered	CITY	MISC	1
Kim-owned	CITY	MISC	1
Kim-controlled	CITY	MISC	1
Kim-raised	CITY	MISC	1
Kim-educated	CITY	MISC	1
Kim-backed	CITY	MISC	1
Kim-trained	CITY	MISC	1
Kim-born	CITY	MISC	1
Kim-area	CITY	MISC	1
Kim-registered	CITY	MISC	1
Kirby-headquartered	CITY	MISC	1
Kirby-owned	CITY	MISC	1
Kirby-controlled	CITY	MISC	1
Kirby-raised	CITY	MISC	1
Kirby-educated	CITY	MISC	1
Kirby-backed	CITY	MISC	1
Kirby-trained	CITY	MISC	1
Kirby-born	CITY	MISC	1
Kirby-area	CITY	MISC	1
Kirby-registered	CITY	MISC	1
Lara-headquartered	CITY	MISC	1
Lara-owned	CITY	MISC	1
Lara-controlled	CITY	MISC	1
Lara-raised	CITY	MISC	1
Lara-educated	CITY	MISC	1
Lara-backed	CITY	MISC	1
Lara-trained	CITY	MISC	1
Lara-born	CITY	MISC	1
Lara-area	CITY	MISC	1
Lara-registered	CITY	MISC	1
Lawrence-headquartered	CITY	MISC	1
Lawrence-owned	CITY	MISC	1
Lawrence-controlled	CITY	MISC	1
Lawrence-raised	CITY	MISC	1
Lawrence-educated	CITY	MISC	1
Lawrence-backed	CITY	MISC	1
Lawrence-trained	CITY	MISC	1
Lawrence-born	CITY	MISC	1
Lawrence-area	CITY	MISC	1
Lawrence-registered	CITY	MISC	1
Lee-headquartered	CITY	MISC	1
Lee-owned	CITY	MISC	1
Lee-controlled	CITY	MISC	1
Lee-raised	CITY	MISC	1
Lee-educated	CITY	MISC	1
Lee-backed	CITY	MISC	1
Lee-trained	CITY	MISC	1
Lee-born	CITY	MISC	1
Lee-area	CITY	MISC	1
Lee-registered	CITY	MISC	1
Leon-headquartered	CITY	MISC	1
Leon-owned	CITY	MISC	1
Leon-controlled	CITY	MISC	1
Leon-raised	CITY	MISC	1
Leon-educated	CITY	MISC	1
Leon-backed	CITY	MISC	1
Leon-trained	CITY	MISC	1
Leon-born	CITY	MISC	1
Leon-area	CITY	MISC	1
Leon-registered	CITY	MISC	1
Li-headquartered	CITY	MISC	1
Li-owned	CITY	MISC	1
Li-controlled	CITY	MISC	1
Li-raised	CITY	MISC	1
Li-educated	CITY	MISC	1
Li-backed	CITY	MISC	1
Li-trained	CITY	MISC	1
Li-born	CITY	MISC	1
Li-area	CITY	MISC	1
Li-registered	CITY	MISC	1
Livingston-headquartered	CITY	MISC	1
Livingston-owned	CITY	MISC	1
Livingston-controlled	CITY	MISC	1
Livingston-raised	CITY	MISC	1
Livingston-educated	CITY	MISC	1
Livingston-backed	CITY	MISC	1
Livingston-trained	CITY	MISC	1
Livingston-born	CITY	MISC	1
Livingston-area	CITY	MISC	1
Livingston-registered	CITY	MISC	1
Logan-headquartered	CITY	MISC	1
Logan-owned	CITY	MISC	1
Logan-controlled	CITY	MISC	1
Logan-raised	CITY	MISC	1
Logan-educated	CITY	MISC	1
Logan-backed	CITY	MISC	1
Logan-trained	CITY	MISC	1
Logan-born	CITY	MISC	1
Logan-area	CITY	MISC	1
Logan-registered	CITY	MISC	1
Long-headquartered	CITY	MISC	1
Long-owned	CITY	MISC	1
Long-controlled	CITY	MISC	1
Long-raised	CITY	MISC	1
Long-educated	CITY	MISC	1
Long-backed	CITY	MISC	1
Long-trained	CITY	MISC	1
Long-born	CITY	MISC	1
Long-area	CITY	MISC	1
Long-registered	CITY	MISC	1
Lopez-headquartered	CITY	MISC	1
Lopez-owned	CITY	MISC	1
Lopez-controlled	CITY	MISC	1
Lopez-raised	CITY	MISC	1
Lopez-educated	CITY	MISC	1
Lopez-backed	CITY	MISC	1
Lopez-trained	CITY	MISC	1
Lopez-born	CITY	MISC	1
Lopez-area	CITY	MISC	1
Lopez-registered	CITY	MISC	1
Lucero-headquartered	CITY	MISC	1
Lucero-owned	CITY	MISC	1
Lucero-controlled	CITY	MISC	1
Lucero-raised	CITY	MISC	1
Lucero-educated	CITY	MISC	1
Lucero-backed	CITY	MISC	1
Lucero-trained	CITY	MISC	1
Lucero-born	CITY	MISC	1
Lucero-area	CITY	MISC	1
Lucero-registered	CITY	MISC	1
Luna-headquartered	CITY	MISC	1
Luna-owned	CITY	MISC	1
Luna-controlled	CITY	MISC	1
Luna-raised	CITY	MISC	1
Luna-educated	CITY	MISC	1
Luna-backed	CITY	MISC	1
Luna-trained	CITY	MISC	1
Luna-born	CITY	MISC	1
Luna-area	CITY	MISC	1
Luna-registered	CITY	MISC	1
Lutz-headquartered	CITY	MISC	1
Lutz-owned	CITY	MISC	1
Lutz-controlled	CITY	MISC	1
Lutz-raised	CITY	MISC	1
Lutz-educated	CITY	MISC	1
Lutz-backed	CITY	MISC	1
Lutz-trained	CITY	MISC	1
Lutz-born	CITY	MISC	1
Lutz-area	CITY	MISC	1
Lutz-registered	CITY	MISC	1
Lynn-headquartered	CITY	MISC	1
Lynn-owned	CITY	MISC	1
Lynn-controlled	CITY	MISC	1
Lynn-raised	CITY	MISC	1
Lynn-educated	CITY	MISC	1
Lynn-backed	CITY	MISC	1
Lynn-trained	CITY	MISC	1
Lynn-born	CITY	MISC	1
Lynn-area	CITY	MISC	1
Lynn-registered	CITY	MISC	1
Lyons-headquartered	CITY	MISC	1
Lyons-owned	CITY	MISC	1
Lyons-controlled	CITY	MISC	1
Lyons-raised	CITY	MISC	1
Lyons-educated	CITY	MISC	1
Lyons-backed	CITY	MISC	1
Lyons-trained	CITY	MISC	1
Lyons-born	CITY	MISC	1
Lyons-area	CITY	MISC	1
Lyons-registered	CITY	MISC	1
Maldonado-headquartered	CITY	MISC	1
Maldonado-owned	CITY	MISC	1
Maldonado-controlled	CITY	MISC	1
Maldonado-raised	CITY	MISC	1
Maldonado-educated	CITY	MISC	1
Maldonado-backed	CITY	MISC	1
Maldonado-trained	CITY	MISC	1
Maldonado-born	CITY	MISC	1
Maldonado-area	CITY	MISC	1
Maldonado-registered	CITY	MISC	1
Marks-headquartered	CITY	MISC	1
Marks-owned	CITY	MISC	1
Marks-controlled	CITY	MISC	1
Marks-raised	CITY	MISC	1
Marks-educated	CITY	MISC	1
Marks-backed	CITY	MISC	1
Marks-trained	CITY	MISC	1
Marks-born	CITY	MISC	1
Marks-area	CITY	MISC	1
Marks-registered	CITY	MISC	1
Marshall-headquartered	CITY	MISC	1
Marshall-owned	CITY	MISC	1
Marshall-controlled	CITY	MISC	1
Marshall-raised	CITY	MISC	1
Marshall-educated	CITY	MISC	1
Marshall-backed	CITY	MISC	1
Marshall-trained	CITY	MISC	1
Marshall-born	CITY	MISC	1
Marshall-area	CITY	MISC	1
Marshall-registered	CITY	MISC	1
Martin-headquartered	CITY	MISC	1
Martin-owned	CITY	MISC	1
Martin-controlled	CITY	MISC	1
Martin-raised	CITY	MISC	1
Martin-educated	CITY	MISC	1
Martin-backed	CITY	MISC	1
Martin-trained	CITY	MISC	1
Martin-born	CITY	MISC	1
Martin-area	CITY	MISC	1
Martin-registered	CITY	MISC	1
Martinez-headquartered	CITY	MISC	1
Martinez-owned	CITY	MISC	1
Martinez-controlled	CITY	MISC	1
Martinez-raised	CITY	MISC	1
Martinez-educated	CITY	MISC	1
Martinez-backed	CITY	MISC	1
Martinez-trained	CITY	MISC	1
Martinez-born	CITY	MISC	1
Martinez-area	CITY	MISC	1
Martinez-registered	CITY	MISC	1
Mason-headquartered	CITY	MISC	1
Mason-owned	CITY	MISC	1
Mason-controlled	CITY	MISC	1
Mason-raised	CITY	MISC	1
Mason-educated	CITY	MISC	1
Mason-backed	CITY	MISC	1
Mason-trained	CITY	MISC	1
Mason-born	CITY	MISC	1
Mason-area	CITY	MISC	1
Mason-registered	CITY	MISC	1
Mata-headquartered	CITY	MISC	1
Mata-owned	CITY	MISC	1
Mata-controlled	CITY	MISC	1
Mata-raised	CITY	MISC	1
Mata-educated	CITY	MISC	1
Mata-backed	CITY	MISC	1
Mata-trained	CITY	MISC	1
Mata-born	CITY	MISC	1
Mata-area	CITY	MISC	1
Mata-registered	CITY	MISC	1
Matthews-headquartered	CITY	MISC	1
Matthews-owned	CITY	MISC	1
Matthews-controlled	CITY	MISC	1
Matthews-raised	CITY	MISC	1
Matthews-educated	CITY	MISC	1
Matthews-backed	CITY	MISC	1
Matthews-trained	CITY	MISC	1
Matthews-born	CITY	MISC	1
Matthews-area	CITY	MISC	1
Matthews-registered	CITY	MISC	1
Maynard-headquartered	CITY	MISC	1
Maynard-owned	CITY	MISC	1
Maynard-controlled	CITY	MISC	1
Maynard-raised	CITY	MISC	1
Maynard-educated	CITY	MISC	1
Maynard-backed	CITY	MISC	1
Maynard-trained	CITY	MISC	1
Maynard-born	CITY	MISC	1
Maynard-area	CITY	MISC	1
Maynard-registered	CITY	MISC	1
Mayo-headquartered	CITY	MISC	1
Mayo-owned	CITY	MISC	1
Mayo-controlled	CITY	MISC	1
Mayo-raised	CITY	MISC	1
Mayo-educated	CITY	MISC	1
Mayo-backed	CITY	MISC	1
Mayo-trained	CITY	MISC	1
Mayo-born	CITY	MISC	1
Mayo-area	CITY	MISC	1
Mayo-registered	CITY	MISC	1
Medina-headquartered	CITY	MISC	1
Medina-owned	CITY	MISC	1
Medina-controlled	CITY	MISC	1
Medina-raised	CITY	MISC	1
Medina-educated	CITY	MISC	1
Medina-backed	CITY	MISC	1
Medina-trained	CITY	MISC	1
Medina-born	CITY	MISC	1
Medina-area	CITY	MISC	1
Medina-registered	CITY	MISC	1
Melton-headquartered	CITY	MISC	1
Melton-owned	CITY	MISC	1
Melton-controlled	CITY	MISC	1
Melton-raised	CITY	MISC	1
Melton-educated	CITY	MISC	1
Melton-backed	CITY	MISC	1
Melton-trained	CITY	MISC	1
Melton-born	CITY	MISC	1
Melton-area	CITY	MISC	1
Melton-registered	CITY	MISC	1
Mendez-headquartered	CITY	MISC	1
Mendez-owned	CITY	MISC	1
Mendez-controlled	CITY	MISC	1
Mendez-raised	CITY	MISC	1
Mendez-educated	CITY	MISC	1
Mendez-backed	CITY	MISC	1
Mendez-trained	CITY	MISC	1
Mendez-born	CITY	MISC	1
Mendez-area	CITY	MISC	1
Mendez-registered	CITY	MISC	1
Mendoza-headquartered	CITY	MISC	1
Mendoza-owned	CITY	MISC	1
Mendoza-controlled	CITY	MISC	1
Mendoza-raised	CITY	MISC	1
Mendoza-educated	CITY	MISC	1
Mendoza-backed	CITY	MISC	1
Mendoza-trained	CITY	MISC	1
Mendoza-born	CITY	MISC	1
Mendoza-area	CITY	MISC	1
Mendoza-registered	CITY	MISC	1
Merritt-headquartered	CITY	MISC	1
Merritt-owned	CITY	MISC	1
Merritt-controlled	CITY	MISC	1
Merritt-raised	CITY	MISC	1
Merritt-educated	CITY	MISC	1
Merritt-backed	CITY	MISC	1
Merritt-trained	CITY	MISC	1
Merritt-born	CITY	MISC	1
Merritt-area	CITY	MISC	1
Merritt-registered	CITY	MISC	1
Middleton-headquartered	CITY	MISC	1
Middleton-owned	CITY	MISC	1
Middleton-controlled	CITY	MISC	1
Middleton-raised	CITY	MISC	1
Middleton-educated	CITY	MISC	1
Middleton-backed	CITY	MISC	1
Middleton-trained	CITY	MISC	1
Middleton-born	CITY	MISC	1
Middleton-area	CITY	MISC	1
Middleton-registered	CITY	MISC	1
Miranda-headquartered	CITY	MISC	1
Miranda-owned	CITY	MISC	1
Miranda-controlled	CITY	MISC	1
Miranda-raised	CITY	MISC	1
Miranda-educated	CITY	MISC	1
Miranda-backed	CITY	MISC	1
Miranda-trained	CITY	MISC	1
Miranda-born	CITY	MISC	1
Miranda-area	CITY	MISC	1
Miranda-registered	CITY	MISC	1
Mitchell-headquartered	CITY	MISC	1
Mitchell-owned	CITY	MISC	1
Mitchell-controlled	CITY	MISC	1
Mitchell-raised	CITY	MISC	1
Mitchell-educated	CITY	MISC	1
Mitchell-backed	CITY	MISC	1
Mitchell-trained	CITY	MISC	1
Mitchell-born	CITY	MISC	1
Mitchell-area	CITY	MISC	1
Mitchell-registered	CITY	MISC	1
Molina-headquartered	CITY	MISC	1
Molina-owned	CITY	MISC	1
Molina-controlled	CITY	MISC	1
Molina-raised	CITY	MISC	1
Molina-educated	CITY	MISC	1
Molina-backed	CITY	MISC	1
Molina-trained	CITY	MISC	1
Molina-born	CITY	MISC	1
Molina-area	CITY	MISC	1
Molina-registered	CITY	MISC	1
Monroe-headquartered	CITY	MISC	1
Monroe-owned	CITY	MISC	1
Monroe-controlled	CITY	MISC	1
Monroe-raised	CITY	MISC	1
Monroe-educated	CITY	MISC	1
Monroe-backed	CITY	MISC	1
Monroe-trained	CITY	MISC	1
Monroe-born	CITY	MISC	1
Monroe-area	CITY	MISC	1
Monroe-registered	CITY	MISC	1
Montgomery-headquartered	CITY	MISC	1
Montgomery-owned	CITY	MISC	1
Montgomery-controlled	CITY	MISC	1
Montgomery-raised	CITY	MISC	1
Montgomery-educated	CITY	MISC	1
Montgomery-backed	CITY	MISC	1
Montgomery-trained	CITY	MISC	1
Montgomery-born	CITY	MISC	1
Montgomery-area	CITY	MISC	1
Montgomery-registered	CITY	MISC	1
Moore-headquartered	CITY	MISC	1
Moore-owned	CITY	MISC	1
Moore-controlled	CITY	MISC	1
Moore-raised	CITY	MISC	1
Moore-educated	CITY	MISC	1
Moore-backed	CITY	MISC	1
Moore-trained	CITY	MISC	1
Moore-born	CITY	MISC	1
Moore-area	CITY	MISC	1
Moore-registered	CITY	MISC	1
Mora-headquartered	CITY	MISC	1
Mora-owned	CITY	MISC	1
Mora-controlled	CITY	MISC	1
Mora-raised	CITY	MISC	1
Mora-educated	CITY	MISC	1
Mora-backed	CITY	MISC	1
Mora-trained	CITY	MISC	1
Mora-born	CITY	MISC	1
Mora-area	CITY	MISC	1
Mora-registered	CITY	MISC	1
Morales-headquartered	CITY	MISC	1
Morales-owned	CITY	MISC	1
Morales-controlled	CITY	MISC	1
Morales-raised	CITY	MISC	1
Morales-educated	CITY	MISC	1
Morales-backed	CITY	MISC	1
Morales-trained	CITY	MISC	1
Morales-born	CITY	MISC	1
Morales-area	CITY	MISC	1
Morales-registered	CITY	MISC	1
Moreno-headquartered	CITY	MISC	1
Moreno-owned	CITY	MISC	1
Moreno-controlled	CITY	MISC	1
Moreno-raised	CITY	MISC	1
Moreno-educated	CITY	MISC	1
Moreno-backed	CITY	MISC	1
Moreno-trained	CITY	MISC	1
Moreno-born	CITY	MISC	1
Moreno-area	CITY	MISC	1
Moreno-registered	CITY	MISC	1
Morris-headquartered	CITY	MISC	1
Morris-owned	CITY	MISC	1
Morris-controlled	CITY	MISC	1
Morris-raised	CITY	MISC	1
Morris-educated	CITY	MISC	1
Morris-backed	CITY	MISC	1
Morris-trained	CITY	MISC	1
Morris-born	CITY	MISC	1
Morris-area	CITY	MISC	1
Morris-registered	CITY	MISC	1
Morton-headquartered	CITY	MISC	1
Morton-owned	CITY	MISC	1
Morton-controlled	CITY	MISC	1
Morton-raised	CITY	MISC	1
Morton-educated	CITY	MISC	1
Morton-backed	CITY	MISC	1
Morton-trained	CITY	MISC	1
Morton-born	CITY	MISC	1
Morton-area	CITY	MISC	1
Morton-registered	CITY	MISC	1
Munoz-headquartered	CITY	MISC	1
Munoz-owned	CITY	MISC	1
Munoz-controlled	CITY	MISC	1
Munoz-raised	CITY	MISC	1
Munoz-educated	CITY	MISC	1
Munoz-backed	CITY	MISC	1
Munoz-trained	CITY	MISC	1
Munoz-born	CITY	MISC	1
Munoz-area	CITY	MISC	1
Munoz-registered	CITY	MISC	1
Murillo-headquartered	CITY	MISC	1
Murillo-owned	CITY	MISC	1
Murillo-controlled	CITY	MISC	1
Murillo-raised	CITY	MISC	1
Murillo-educated	CITY	MISC	1
Murillo-backed	CITY	MISC	1
Murillo-trained	CITY	MISC	1
Murillo-born	CITY	MISC	1
Murillo-area	CITY	MISC	1
Murillo-registered	CITY	MISC	1
Murphy-headquartered	CITY	MISC	1
Murphy-owned	CITY	MISC	1
Murphy-controlled	CITY	MISC	1
Murphy-raised	CITY	MISC	1
Murphy-educated	CITY	MISC	1
Murphy-backed	CITY	MISC	1
Murphy-trained	CITY	MISC	1
Murphy-born	CITY	MISC	1
Murphy-area	CITY	MISC	1
Murphy-registered	CITY	MISC	1
Murray-headquartered	CITY	MISC	1
Murray-owned	CITY	MISC	1
Murray-controlled	CITY	MISC	1
Murray-raised	CITY	MISC	1
Murray-educated	CITY	MISC	1
Murray-backed	CITY	MISC	1
Murray-trained	CITY	MISC	1
Murray-born	CITY	MISC	1
Murray-area	CITY	MISC	1
Murray-registered	CITY	MISC	1
Nelson-headquartered	CITY	MISC	1
Nelson-owned	CITY	MISC	1
Nelson-controlled	CITY	MISC	1
Nelson-raised	CITY	MISC	1
Nelson-educated	CITY	MISC	1
Nelson-backed	CITY	MISC	1
Nelson-trained	CITY	MISC	1
Nelson-born	CITY	MISC	1
Nelson-area	CITY	MISC	1
Nelson-registered	CITY	MISC	1
Newton-headquartered	CITY	MISC	1
Newton-owned	CITY	MISC	1
Newton-controlled	CITY	MISC	1
Newton-raised	CITY	MISC	1
Newton-educated	CITY	MISC	1
Newton-backed	CITY	MISC	1
Newton-trained	CITY	MISC	1
Newton-born	CITY	MISC	1
Newton-area	CITY	MISC	1
Newton-registered	CITY	MISC	1
Norman-headquartered	CITY	MISC	1
Norman-owned	CITY	MISC	1
Norman-controlled	CITY	MISC	1
Norman-raised	CITY	MISC	1
Norman-educated	CITY	MISC	1
Norman-backed	CITY	MISC	1
Norman-trained	CITY	MISC	1
Norman-born	CITY	MISC	1
Norman-area	CITY	MISC	1
Norman-registered	CITY	MISC	1
Norton-headquartered	CITY	MISC	1
Norton-owned	CITY	MISC	1
Norton-controlled	CITY	MISC	1
Norton-raised	CITY	MISC	1
Norton-educated	CITY	MISC	1
Norton-backed	CITY	MISC	1
Norton-trained	CITY	MISC	1
Norton-born	CITY	MISC	1
Norton-area	CITY	MISC	1
Norton-registered	CITY	MISC	1
Oliver-headquartered	CITY	MISC	1
Oliver-owned	CITY	MISC	1
Oliver-controlled	CITY	MISC	1
Oliver-raised	CITY	MISC	1
Oliver-educated	CITY	MISC	1
Oliver-backed	CITY	MISC	1
Oliver-trained	CITY	MISC	1
Oliver-born	CITY	MISC	1
Oliver-area	CITY	MISC	1
Oliver-registered	CITY	MISC	1
Ortega-headquartered	CITY	MISC	1
Ortega-owned	CITY	MISC	1
Ortega-controlled	CITY	MISC	1
Ortega-raised	CITY	MISC	1
Ortega-educated	CITY	MISC	1
Ortega-backed	CITY	MISC	1
Ortega-trained	CITY	MISC	1
Ortega-born	CITY	MISC	1
Ortega-area	CITY	MISC	1
Ortega-registered	CITY	MISC	1
Padilla-headquartered	CITY	MISC	1
Padilla-owned	CITY	MISC	1
Padilla-controlled	CITY	MISC	1
Padilla-raised	CITY	MISC	1
Padilla-educated	CITY	MISC	1
Padilla-backed	CITY	MISC	1
Padilla-trained	CITY	MISC	1
Padilla-born	CITY	MISC	1
Padilla-area	CITY	MISC	1
Padilla-registered	CITY	MISC	1
Palmer-headquartered	CITY	MISC	1
Palmer-owned	CITY	MISC	1
Palmer-controlled	CITY	MISC	1
Palmer-raised	CITY	MISC	1
Palmer-educated	CITY	MISC	1
Palmer-backed	CITY	MISC	1
Palmer-trained	CITY	MISC	1
Palmer-born	CITY	MISC	1
Palmer-area	CITY	MISC	1
Palmer-registered	CITY	MISC	1
Parker-headquartered	CITY	MISC	1
Parker-owned	CITY	MISC	1
Parker-controlled	CITY	MISC	1
Parker-raised	CITY	MISC	1
Parker-educated	CITY	MISC	1
Parker-backed	CITY	MISC	1
Parker-trained	CITY	MISC	1
Parker-born	CITY	MISC	1
Parker-area	CITY	MISC	1
Parker-registered	CITY	MISC	1
Parsons-headquartered	CITY	MISC	1
Parsons-owned	CITY	MISC	1
Parsons-controlled	CITY	MISC	1
Parsons-raised	CITY	MISC	1
Parsons-educated	CITY	MISC	1
Parsons-backed	CITY	MISC	1
Parsons-trained	CITY	MISC	1
Parsons-born	CITY	MISC	1
Parsons-area	CITY	MISC	1
Parsons-registered	CITY	MISC	1
Patterson-headquartered	CITY	MISC	1
Patterson-owned	CITY	MISC	1
Patterson-controlled	CITY	MISC	1
Patterson-raised	CITY	MISC	1
Patterson-educated	CITY	MISC	1
Patterson-backed	CITY	MISC	1
Patterson-trained	CITY	MISC	1
Patterson-born	CITY	MISC	1
Patterson-area	CITY	MISC	1
Patterson-registered	CITY	MISC	1
Pena-headquartered	CITY	MISC	1
Pena-owned	CITY	MISC	1
Pena-controlled	CITY	MISC	1
Pena-raised	CITY	MISC	1
Pena-educated	CITY	MISC	1
Pena-backed	CITY	MISC	1
Pena-trained	CITY	MISC	1
Pena-born	CITY	MISC	1
Pena-area	CITY	MISC	1
Pena-registered	CITY	MISC	1
Perez-headquartered	CITY	MISC	1
Perez-owned	CITY	MISC	1
Perez-controlled	CITY	MISC	1
Perez-raised	CITY	MISC	1
Perez-educated	CITY	MISC	1
Perez-backed	CITY	MISC	1
Perez-trained	CITY	MISC	1
Perez-born	CITY	MISC	1
Perez-area	CITY	MISC	1
Perez-registered	CITY	MISC	1
Perry-headquartered	CITY	MISC	1
Perry-owned	CITY	MISC	1
Perry-controlled	CITY	MISC	1
Perry-raised	CITY	MISC	1
Perry-educated	CITY	MISC	1
Perry-backed	CITY	MISC	1
Perry-trained	CITY	MISC	1
Perry-born	CITY	MISC	1
Perry-area	CITY	MISC	1
Perry-registered	CITY	MISC	1
Phoenix-headquartered	CITY	MISC	1
Phoenix-owned	CITY	MISC	1
Phoenix-controlled	CITY	MISC	1
Phoenix-raised	CITY	MISC	1
Phoenix-educated	CITY	MISC	1
Phoenix-backed	CITY	MISC	1
Phoenix-trained	CITY	MISC	1
Phoenix-born	CITY	MISC	1
Phoenix-area	CITY	MISC	1
Phoenix-registered	CITY	MISC	1
Poole-headquartered	CITY	MISC	1
Poole-owned	CITY	MISC	1
Poole-controlled	CITY	MISC	1
Poole-raised	CITY	MISC	1
Poole-educated	CITY	MISC	1
Poole-backed	CITY	MISC	1
Poole-trained	CITY	MISC	1
Poole-born	CITY	MISC	1
Poole-area	CITY	MISC	1
Poole-registered	CITY	MISC	1
Powell-headquartered	CITY	MISC	1
Powell-owned	CITY	MISC	1
Powell-controlled	CITY	MISC	1
Powell-raised	CITY	MISC	1
Powell-educated	CITY	MISC	1
Powell-backed	CITY	MISC	1
Powell-trained	CITY	MISC	1
Powell-born	CITY	MISC	1
Powell-area	CITY	MISC	1
Powell-registered	CITY	MISC	1
Preston-headquartered	CITY	MISC	1
Preston-owned	CITY	MISC	1
Preston-controlled	CITY	MISC	1
Preston-raised	CITY	MISC	1
Preston-educated	CITY	MISC	1
Preston-backed	CITY	MISC	1
Preston-trained	CITY	MISC	1
Preston-born	CITY	MISC	1
Preston-area	CITY	MISC	1
Preston-registered	CITY	MISC	1
Price-headquartered	CITY	MISC	1
Price-owned	CITY	MISC	1
Price-controlled	CITY	MISC	1
Price-raised	CITY	MISC	1
Price-educated	CITY	MISC	1
Price-backed	CITY	MISC	1
Price-trained	CITY	MISC	1
Price-born	CITY	MISC	1
Price-area	CITY	MISC	1
Price-registered	CITY	MISC	1
Ramos-headquartered	CITY	MISC	1
Ramos-owned	CITY	MISC	1
Ramos-controlled	CITY	MISC	1
Ramos-raised	CITY	MISC	1
Ramos-educated	CITY	MISC	1
Ramos-backed	CITY	MISC	1
Ramos-trained	CITY	MISC	1
Ramos-born	CITY	MISC	1
Ramos-area	CITY	MISC	1
Ramos-registered	CITY	MISC	1
Ramsey-headquartered	CITY	MISC	1
Ramsey-owned	CITY	MISC	1
Ramsey-controlled	CITY	MISC	1
Ramsey-raised	CITY	MISC	1
Ramsey-educated	CITY	MISC	1
Ramsey-backed	CITY	MISC	1
Ramsey-trained	CITY	MISC	1
Ramsey-born	CITY	MISC	1
Ramsey-area	CITY	MISC	1
Ramsey-registered	CITY	MISC	1
Randolph-headquartered	CITY	MISC	1
Randolph-owned	CITY	MISC	1
Randolph-controlled	CITY	MISC	1
Randolph-raised	CITY	MISC	1
Randolph-educated	CITY	MISC	1
Randolph-backed	CITY	MISC	1
Randolph-trained	CITY	MISC	1
Randolph-born	CITY	MISC	1
Randolph-area	CITY	MISC	1
Randolph-registered	CITY	MISC	1
Ray-headquartered	CITY	MISC	1
Ray-owned	CITY	MISC	1
Ray-controlled	CITY	MISC	1
Ray-raised	CITY	MISC	1
Ray-educated	CITY	MISC	1
Ray-backed	CITY	MISC	1
Ray-trained	CITY	MISC	1
Ray-born	CITY	MISC	1
Ray-area	CITY	MISC	1
Ray-registered	CITY	MISC	1
Raymond-headquartered	CITY	MISC	1
Raymond-owned	CITY	MISC	1
Raymond-controlled	CITY	MISC	1
Raymond-raised	CITY	MISC	1
Raymond-educated	CITY	MISC	1
Raymond-backed	CITY	MISC	1
Raymond-trained	CITY	MISC	1
Raymond-born	CITY	MISC	1
Raymond-area	CITY	MISC	1
Raymond-registered	CITY	MISC	1
Reyes-headquartered	CITY	MISC	1
Reyes-owned	CITY	MISC	1
Reyes-controlled	CITY	MISC	1
Reyes-raised	CITY	MISC	1
Reyes-educated	CITY	MISC	1
Reyes-backed	CITY	MISC	1
Reyes-trained	CITY	MISC	1
Reyes-born	CITY	MISC	1
Reyes-area	CITY	MISC	1
Reyes-registered	CITY	MISC	1
Richardson-headquartered	CITY	MISC	1
Richardson-owned	CITY	MISC	1
Richardson-controlled	CITY	MISC	1
Richardson-raised	CITY	MISC	1
Richardson-educated	CITY	MISC	1
Richardson-backed	CITY	MISC	1
Richardson-trained	CITY	MISC	1
Richardson-born	CITY	MISC	1
Richardson-area	CITY	MISC	1
Richardson-registered	CITY	MISC	1
Richmond-headquartered	CITY	MISC	1
Richmond-owned	CITY	MISC	1
Richmond-controlled	CITY	MISC	1
Richmond-raised	CITY	MISC	1
Richmond-educated	CITY	MISC	1
Richmond-backed	CITY	MISC	1
Richmond-trained	CITY	MISC	1
Richmond-born	CITY	MISC	1
Richmond-area	CITY	MISC	1
Richmond-registered	CITY	MISC	1
Rivas-headquartered	CITY	MISC	1
Rivas-owned	CITY	MISC	1
Rivas-controlled	CITY	MISC	1
Rivas-raised	CITY	MISC	1
Rivas-educated	CITY	MISC	1
Rivas-backed	CITY	MISC	1
Rivas-trained	CITY	MISC	1
Rivas-born	CITY	MISC	1
Rivas-area	CITY	MISC	1
Rivas-registered	CITY	MISC	1
Rivera-headquartered	CITY	MISC	1
Rivera-owned	CITY	MISC	1
Rivera-controlled	CITY	MISC	1
Rivera-raised	CITY	MISC	1
Rivera-educated	CITY	MISC	1
Rivera-backed	CITY	MISC	1
Rivera-trained	CITY	MISC	1
Rivera-born	CITY	MISC	1
Rivera-area	CITY	MISC	1
Rivera-registered	CITY	MISC	1
Rivers-headquartered	CITY	MISC	1
Rivers-owned	CITY	MISC	1
Rivers-controlled	CITY	MISC	1
Rivers-raised	CITY	MISC	1
Rivers-educated	CITY	MISC	1
Rivers-backed	CITY	MISC	1
Rivers-trained	CITY	MISC	1
Rivers-born	CITY	MISC	1
Rivers-area	CITY	MISC	1
Rivers-registered	CITY	MISC	1
Robertson-headquartered	CITY	MISC	1
Robertson-owned	CITY	MISC	1
Robertson-controlled	CITY	MISC	1
Robertson-raised	CITY	MISC	1
Robertson-educated	CITY	MISC	1
Robertson-backed	CITY	MISC	1
Robertson-trained	CITY	MISC	1
Robertson-born	CITY	MISC	1
Robertson-area	CITY	MISC	1
Robertson-registered	CITY	MISC	1
Robinson-headquartered	CITY	MISC	1
Robinson-owned	CITY	MISC	1
Robinson-controlled	CITY	MISC	1
Robinson-raised	CITY	MISC	1
Robinson-educated	CITY	MISC	1
Robinson-backed	CITY	MISC	1
Robinson-trained	CITY	MISC	1
Robinson-born	CITY	MISC	1
Robinson-area	CITY	MISC	1
Robinson-registered	CITY	MISC	1
Rocha-headquartered	CITY	MISC	1
Rocha-owned	CITY	MISC	1
Rocha-controlled	CITY	MISC	1
Rocha-raised	CITY	MISC	1
Rocha-educated	CITY	MISC	1
Rocha-backed	CITY	MISC	1
Rocha-trained	CITY	MISC	1
Rocha-born	CITY	MISC	1
Rocha-area	CITY	MISC	1
Rocha-registered	CITY	MISC	1
Rogers-headquartered	CITY	MISC	1
Rogers-owned	CITY	MISC	1
Rogers-controlled	CITY	MISC	1
Rogers-raised	CITY	MISC	1
Rogers-educated	CITY	MISC	1
Rogers-backed	CITY	MISC	1
Rogers-trained	CITY	MISC	1
Rogers-born	CITY	MISC	1
Rogers-area	CITY	MISC	1
Rogers-registered	CITY	MISC	1
Roman-headquartered	CITY	MISC	1
Roman-owned	CITY	MISC	1
Roman-controlled	CITY	MISC	1
Roman-raised	CITY	MISC	1
Roman-educated	CITY	MISC	1
Roman-backed	CITY	MISC	1
Roman-trained	CITY	MISC	1
Roman-born	CITY	MISC	1
Roman-area	CITY	MISC	1
Roman-registered	CITY	MISC	1
Rosario-headquartered	CITY	MISC	1
Rosario-owned	CITY	MISC	1
Rosario-controlled	CITY	MISC	1
Rosario-raised	CITY	MISC	1
Rosario-educated	CITY	MISC	1
Rosario-backed	CITY	MISC	1
Rosario-trained	CITY	MISC	1
Rosario-born	CITY	MISC	1
Rosario-area	CITY	MISC	1
Rosario-registered	CITY	MISC	1
Roth-headquartered	CITY	MISC	1
Roth-owned	CITY	MISC	1
Roth-controlled	CITY	MISC	1
Roth-raised	CITY	MISC	1
Roth-educated	CITY	MISC	1
Roth-backed	CITY	MISC	1
Roth-trained	CITY	MISC	1
Roth-born	CITY	MISC	1
Roth-area	CITY	MISC	1
Roth-registered	CITY	MISC	1
Roy-headquartered	CITY	MISC	1
Roy-owned	CITY	MISC	1
Roy-controlled	CITY	MISC	1
Roy-raised	CITY	MISC	1
Roy-educated	CITY	MISC	1
Roy-backed	CITY	MISC	1
Roy-trained	CITY	MISC	1
Roy-born	CITY	MISC	1
Roy-area	CITY	MISC	1
Roy-registered	CITY	MISC	1
Rubio-headquartered	CITY	MISC	1
Rubio-owned	CITY	MISC	1
Rubio-controlled	CITY	MISC	1
Rubio-raised	CITY	MISC	1
Rubio-educated	CITY	MISC	1
Rubio-backed	CITY	MISC	1
Rubio-trained	CITY	MISC	1
Rubio-born	CITY	MISC	1
Rubio-area	CITY	MISC	1
Rubio-registered	CITY	MISC	1
Ruiz-headquartered	CITY	MISC	1
Ruiz-owned	CITY	MISC	1
Ruiz-controlled	CITY	MISC	1
Ruiz-raised	CITY	MISC	1
Ruiz-educated	CITY	MISC	1
Ruiz-backed	CITY	MISC	1
Ruiz-trained	CITY	MISC	1
Ruiz-born	CITY	MISC	1
Ruiz-area	CITY	MISC	1
Ruiz-registered	CITY	MISC	1
Rush-headquartered	CITY	MISC	1
Rush-owned	CITY	MISC	1
Rush-controlled	CITY	MISC	1
Rush-raised	CITY	MISC	1
Rush-educated	CITY	MISC	1
Rush-backed	CITY	MISC	1
Rush-trained	CITY	MISC	1
Rush-born	CITY	MISC	1
Rush-area	CITY	MISC	1
Rush-registered	CITY	MISC	1
Russell-headquartered	CITY	MISC	1
Russell-owned	CITY	MISC	1
Russell-controlled	CITY	MISC	1
Russell-raised	CITY	MISC	1
Russell-educated	CITY	MISC	1
Russell-backed	CITY	MISC	1
Russell-trained	CITY	MISC	1
Russell-born	CITY	MISC	1
Russell-area	CITY	MISC	1
Russell-registered	CITY	MISC	1
Salas-headquartered	CITY	MISC	1
Salas-owned	CITY	MISC	1
Salas-controlled	CITY	MISC	1
Salas-raised	CITY	MISC	1
Salas-educated	CITY	MISC	1
Salas-backed	CITY	MISC	1
Salas-trained	CITY	MISC	1
Salas-born	CITY	MISC	1
Salas-area	CITY	MISC	1
Salas-registered	CITY	MISC	1
Salinas-headquartered	CITY	MISC	1
Salinas-owned	CITY	MISC	1
Salinas-controlled	CITY	MISC	1
Salinas-raised	CITY	MISC	1
Salinas-educated	CITY	MISC	1
Salinas-backed	CITY	MISC	1
Salinas-trained	CITY	MISC	1
Salinas-born	CITY	MISC	1
Salinas-area	CITY	MISC	1
Salinas-registered	CITY	MISC	1
Sanchez-headquartered	CITY	MISC	1
Sanchez-owned	CITY	MISC	1
Sanchez-controlled	CITY	MISC	1
Sanchez-raised	CITY	MISC	1
Sanchez-educated	CITY	MISC	1
Sanchez-backed	CITY	MISC	1
Sanchez-trained	CITY	MISC	1
Sanchez-born	CITY	MISC	1
Sanchez-area	CITY	MISC	1
Sanchez-registered	CITY	MISC	1
Sanford-headquartered	CITY	MISC	1
Sanford-owned	CITY	MISC	1
Sanford-controlled	CITY	MISC	1
Sanford-raised	CITY	MISC	1
Sanford-educated	CITY	MISC	1
Sanford-backed	CITY	MISC	1
Sanford-trained	CITY	MISC	1
Sanford-born	CITY	MISC	1
Sanford-area	CITY	MISC	1
Sanford-registered	CITY	MISC	1
Santana-headquartered	CITY	MISC	1
Santana-owned	CITY	MISC	1
Santana-controlled	CITY	MISC	1
Santana-raised	CITY	MISC	1
Santana-educated	CITY	MISC	1
Santana-backed	CITY	MISC	1
Santana-trained	CITY	MISC	1
Santana-born	CITY	MISC	1
Santana-area	CITY	MISC	1
Santana-registered	CITY	MISC	1
Santiago-headquartered	CITY	MISC	1
Santiago-owned	CITY	MISC	1
Santiago-controlled	CITY	MISC	1
Santiago-raised	CITY	MISC	1
Santiago-educated	CITY	MISC	1
Santiago-backed	CITY	MISC	1
Santiago-trained	CITY	MISC	1
Santiago-born	CITY	MISC	1
Santiago-area	CITY	MISC	1
Santiago-registered	CITY	MISC	1
Santos-headquartered	CITY	MISC	1
Santos-owned	CITY	MISC	1
Santos-controlled	CITY	MISC	1
Santos-raised	CITY	MISC	1
Santos-educated	CITY	MISC	1
Santos-backed	CITY	MISC	1
Santos-trained	CITY	MISC	1
Santos-born	CITY	MISC	1
Santos-area	CITY	MISC	1
Santos-registered	CITY	MISC	1
Savage-headquartered	CITY	MISC	1
Savage-owned	CITY	MISC	1
Savage-controlled	CITY	MISC	1
Savage-raised	CITY	MISC	1
Savage-educated	CITY	MISC	1
Savage-backed	CITY	MISC	1
Savage-trained	CITY	MISC	1
Savage-born	CITY	MISC	1
Savage-area	CITY	MISC	1
Savage-registered	CITY	MISC	1
Schroeder-headquartered	CITY	MISC	1
Schroeder-owned	CITY	MISC	1
Schroeder-controlled	CITY	MISC	1
Schroeder-raised	CITY	MISC	1
Schroeder-educated	CITY	MISC	1
Schroeder-backed	CITY	MISC	1
Schroeder-trained	CITY	MISC	1
Schroeder-born	CITY	MISC	1
Schroeder-area	CITY	MISC	1
Schroeder-registered	CITY	MISC	1
Shannon-headquartered	CITY	MISC	1
Shannon-owned	CITY	MISC	1
Shannon-controlled	CITY	MISC	1
Shannon-raised	CITY	MISC	1
Shannon-educated	CITY	MISC	1
Shannon-backed	CITY	MISC	1
Shannon-trained	CITY	MISC	1
Shannon-born	CITY	MISC	1
Shannon-area	CITY	MISC	1
Shannon-registered	CITY	MISC	1
Shelton-headquartered	CITY	MISC	1
Shelton-owned	CITY	MISC	1
Shelton-controlled	CITY	MISC	1
Shelton-raised	CITY	MISC	1
Shelton-educated	CITY	MISC	1
Shelton-backed	CITY	MISC	1
Shelton-trained	CITY	MISC	1
Shelton-born	CITY	MISC	1
Shelton-area	CITY	MISC	1
Shelton-registered	CITY	MISC	1
Sherman-headquartered	CITY	MISC	1
Sherman-owned	CITY	MISC	1
Sherman-controlled	CITY	MISC	1
Sherman-raised	CITY	MISC	1
Sherman-educated	CITY	MISC	1
Sherman-backed	CITY	MISC	1
Sherman-trained	CITY	MISC	1
Sherman-born	CITY	MISC	1
Sherman-area	CITY	MISC	1
Sherman-registered	CITY	MISC	1
Singleton-headquartered	CITY	MISC	1
Singleton-owned	CITY	MISC	1
Singleton-controlled	CITY	MISC	1
Singleton-raised	CITY	MISC	1
Singleton-educated	CITY	MISC	1
Singleton-backed	CITY	MISC	1
Singleton-trained	CITY	MISC	1
Singleton-born	CITY	MISC	1
Singleton-area	CITY	MISC	1
Singleton-registered	CITY	MISC	1
Snyder-headquartered	CITY	MISC	1
Snyder-owned	CITY	MISC	1
Snyder-controlled	CITY	MISC	1
Snyder-raised	CITY	MISC	1
Snyder-educated	CITY	MISC	1
Snyder-backed	CITY	MISC	1
Snyder-trained	CITY	MISC	1
Snyder-born	CITY	MISC	1
Snyder-area	CITY	MISC	1
Snyder-registered	CITY	MISC	1
Sparks-headquartered	CITY	MISC	1
Sparks-owned	CITY	MISC	1
Sparks-controlled	CITY	MISC	1
Sparks-raised	CITY	MISC	1
Sparks-educated	CITY	MISC	1
Sparks-backed	CITY	MISC	1
Sparks-trained	CITY	MISC	1
Sparks-born	CITY	MISC	1
Sparks-area	CITY	MISC	1
Sparks-registered	CITY	MISC	1
Spencer-headquartered	CITY	MISC	1
Spencer-owned	CITY	MISC	1
Spencer-controlled	CITY	MISC	1
Spencer-raised	CITY	MISC	1
Spencer-educated	CITY	MISC	1
Spencer-backed	CITY	MISC	1
Spencer-trained	CITY	MISC	1
Spencer-born	CITY	MISC	1
Spencer-area	CITY	MISC	1
Spencer-registered	CITY	MISC	1
Stafford-headquartered	CITY	MISC	1
Stafford-owned	CITY	MISC	1
Stafford-controlled	CITY	MISC	1
Stafford-raised	CITY	MISC	1
Stafford-educated	CITY	MISC	1
Stafford-backed	CITY	MISC	1
Stafford-trained	CITY	MISC	1
Stafford-born	CITY	MISC	1
Stafford-area	CITY	MISC	1
Stafford-registered	CITY	MISC	1
Stanley-headquartered	CITY	MISC	1
Stanley-owned	CITY	MISC	1
Stanley-controlled	CITY	MISC	1
Stanley-raised	CITY	MISC	1
Stanley-educated	CITY	MISC	1
Stanley-backed	CITY	MISC	1
Stanley-trained	CITY	MISC	1
Stanley-born	CITY	MISC	1
Stanley-area	CITY	MISC	1
Stanley-registered	CITY	MISC	1
Stanton-headquartered	CITY	MISC	1
Stanton-owned	CITY	MISC	1
Stanton-controlled	CITY	MISC	1
Stanton-raised	CITY	MISC	1
Stanton-educated	CITY	MISC	1
Stanton-backed	CITY	MISC	1
Stanton-trained	CITY	MISC	1
Stanton-born	CITY	MISC	1
Stanton-area	CITY	MISC	1
Stanton-registered	CITY	MISC	1
Stein-headquartered	CITY	MISC	1
Stein-owned	CITY	MISC	1
Stein-controlled	CITY	MISC	1
Stein-raised	CITY	MISC	1
Stein-educated	CITY	MISC	1
Stein-backed	CITY	MISC	1
Stein-trained	CITY	MISC	1
Stein-born	CITY	MISC	1
Stein-area	CITY	MISC	1
Stein-registered	CITY	MISC	1
Stuart-headquartered	CITY	MISC	1
Stuart-owned	CITY	MISC	1
Stuart-controlled	CITY	MISC	1
Stuart-raised	CITY	MISC	1
Stuart-educated	CITY	MISC	1
Stuart-backed	CITY	MISC	1
Stuart-trained	CITY	MISC	1
Stuart-born	CITY	MISC	1
Stuart-area	CITY	MISC	1
Stuart-registered	CITY	MISC	1
Suarez-headquartered	CITY	MISC	1
Suarez-owned	CITY	MISC	1
Suarez-controlled	CITY	MISC	1
Suarez-raised	CITY	MISC	1
Suarez-educated	CITY	MISC	1
Suarez-backed	CITY	MISC	1
Suarez-trained	CITY	MISC	1
Suarez-born	CITY	MISC	1
Suarez-area	CITY	MISC	1
Suarez-registered	CITY	MISC	1
Sutton-headquartered	CITY	MISC	1
Sutton-owned	CITY	MISC	1
Sutton-controlled	CITY	MISC	1
Sutton-raised	CITY	MISC	1
Sutton-educated	CITY	MISC	1
Sutton-backed	CITY	MISC	1
Sutton-trained	CITY	MISC	1
Sutton-born	CITY	MISC	1
Sutton-area	CITY	MISC	1
Sutton-registered	CITY	MISC	1
Tapia-headquartered	CITY	MISC	1
Tapia-owned	CITY	MISC	1
Tapia-controlled	CITY	MISC	1
Tapia-raised	CITY	MISC	1
Tapia-educated	CITY	MISC	1
Tapia-backed	CITY	MISC	1
Tapia-trained	CITY	MISC	1
Tapia-born	CITY	MISC	1
Tapia-area	CITY	MISC	1
Tapia-registered	CITY	MISC	1
Taylor-headquartered	CITY	MISC	1
Taylor-owned	CITY	MISC	1
Taylor-controlled	CITY	MISC	1
Taylor-raised	CITY	MISC	1
Taylor-educated	CITY	MISC	1
Taylor-backed	CITY	MISC	1
Taylor-trained	CITY	MISC	1
Taylor-born	CITY	MISC	1
Taylor-area	CITY	MISC	1
Taylor-registered	CITY	MISC	1
Terrell-headquartered	CITY	MISC	1
Terrell-owned	CITY	MISC	1
Terrell-controlled	CITY	MISC	1
Terrell-raised	CITY	MISC	1
Terrell-educated	CITY	MISC	1
Terrell-backed	CITY	MISC	1
Terrell-trained	CITY	MISC	1
Terrell-born	CITY	MISC	1
Terrell-area	CITY	MISC	1
Terrell-registered	CITY	MISC	1
Thompson-headquartered	CITY	MISC	1
Thompson-owned	CITY	MISC	1
Thompson-controlled	CITY	MISC	1
Thompson-raised	CITY	MISC	1
Thompson-educated	CITY	MISC	1
Thompson-backed	CITY	MISC	1
Thompson-trained	CITY	MISC	1
Thompson-born	CITY	MISC	1
Thompson-area	CITY	MISC	1
Thompson-registered	CITY	MISC	1
Thornton-headquartered	CITY	MISC	1
Thornton-owned	CITY	MISC	1
Thornton-controlled	CITY	MISC	1
Thornton-raised	CITY	MISC	1
Thornton-educated	CITY	MISC	1
Thornton-backed	CITY	MISC	1
Thornton-trained	CITY	MISC	1
Thornton-born	CITY	MISC	1
Thornton-area	CITY	MISC	1
Thornton-registered	CITY	MISC	1
Torres-headquartered	CITY	MISC	1
Torres-owned	CITY	MISC	1
Torres-controlled	CITY	MISC	1
Torres-raised	CITY	MISC	1
Torres-educated	CITY	MISC	1
Torres-backed	CITY	MISC	1
Torres-trained	CITY	MISC	1
Torres-born	CITY	MISC	1
Torres-area	CITY	MISC	1
Torres-registered	CITY	MISC	1
Townsend-headquartered	CITY	MISC	1
Townsend-owned	CITY	MISC	1
Townsend-controlled	CITY	MISC	1
Townsend-raised	CITY	MISC	1
Townsend-educated	CITY	MISC	1
Townsend-backed	CITY	MISC	1
Townsend-trained	CITY	MISC	1
Townsend-born	CITY	MISC	1
Townsend-area	CITY	MISC	1
Townsend-registered	CITY	MISC	1
Tran-headquartered	CITY	MISC	1
Tran-owned	CITY	MISC	1
Tran-controlled	CITY	MISC	1
Tran-raised	CITY	MISC	1
Tran-educated	CITY	MISC	1
Tran-backed	CITY	MISC	1
Tran-trained	CITY	MISC	1
Tran-born	CITY	MISC	1
Tran-area	CITY	MISC	1
Tran-registered	CITY	MISC	1
Trujillo-headquartered	CITY	MISC	1
Trujillo-owned	CITY	MISC	1
Trujillo-controlled	CITY	MISC	1
Trujillo-raised	CITY	MISC	1
Trujillo-educated	CITY	MISC	1
Trujillo-backed	CITY	MISC	1
Trujillo-trained	CITY	MISC	1
Trujillo-born	CITY	MISC	1
Trujillo-area	CITY	MISC	1
Trujillo-registered	CITY	MISC	1
Tucker-headquartered	CITY	MISC	1
Tucker-owned	CITY	MISC	1
Tucker-controlled	CITY	MISC	1
Tucker-raised	CITY	MISC	1
Tucker-educated	CITY	MISC	1
Tucker-backed	CITY	MISC	1
Tucker-trained	CITY	MISC	1
Tucker-born	CITY	MISC	1
Tucker-area	CITY	MISC	1
Tucker-registered	CITY	MISC	1
Turner-headquartered	CITY	MISC	1
Turner-owned	CITY	MISC	1
Turner-controlled	CITY	MISC	1
Turner-raised	CITY	MISC	1
Turner-educated	CITY	MISC	1
Turner-backed	CITY	MISC	1
Turner-trained	CITY	MISC	1
Turner-born	CITY	MISC	1
Turner-area	CITY	MISC	1
Turner-registered	CITY	MISC	1
Tyler-headquartered	CITY	MISC	1
Tyler-owned	CITY	MISC	1
Tyler-controlled	CITY	MISC	1
Tyler-raised	CITY	MISC	1
Tyler-educated	CITY	MISC	1
Tyler-backed	CITY	MISC	1
Tyler-trained	CITY	MISC	1
Tyler-born	CITY	MISC	1
Tyler-area	CITY	MISC	1
Tyler-registered	CITY	MISC	1
Valdez-headquartered	CITY	MISC	1
Valdez-owned	CITY	MISC	1
Valdez-controlled	CITY	MISC	1
Valdez-raised	CITY	MISC	1
Valdez-educated	CITY	MISC	1
Valdez-backed	CITY	MISC	1
Valdez-trained	CITY	MISC	1
Valdez-born	CITY	MISC	1
Valdez-area	CITY	MISC	1
Valdez-registered	CITY	MISC	1
Valencia-headquartered	CITY	MISC	1
Valencia-owned	CITY	MISC	1
Valencia-controlled	CITY	MISC	1
Valencia-raised	CITY	MISC	1
Valencia-educated	CITY	MISC	1
Valencia-backed	CITY	MISC	1
Valencia-trained	CITY	MISC	1
Valencia-born	CITY	MISC	1
Valencia-area	CITY	MISC	1
Valencia-registered	CITY	MISC	1
Valenzuela-headquartered	CITY	MISC	1
Valenzuela-owned	CITY	MISC	1
Valenzuela-controlled	CITY	MISC	1
Valenzuela-raised	CITY	MISC	1
Valenzuela-educated	CITY	MISC	1
Valenzuela-backed	CITY	MISC	1
Valenzuela-trained	CITY	MISC	1
Valenzuela-born	CITY	MISC	1
Valenzuela-area	CITY	MISC	1
Valenzuela-registered	CITY	MISC	1
Vargas-headquartered	CITY	MISC	1
Vargas-owned	CITY	MISC	1
Vargas-controlled	CITY	MISC	1
Vargas-raised	CITY	MISC	1
Vargas-educated	CITY	MISC	1
Vargas-backed	CITY	MISC	1
Vargas-trained	CITY	MISC	1
Vargas-born	CITY	MISC	1
Vargas-area	CITY	MISC	1
Vargas-registered	CITY	MISC	1
Velez-headquartered	CITY	MISC	1
Velez-owned	CITY	MISC	1
Velez-controlled	CITY	MISC	1
Velez-raised	CITY	MISC	1
Velez-educated	CITY	MISC	1
Velez-backed	CITY	MISC	1
Velez-trained	CITY	MISC	1
Velez-born	CITY	MISC	1
Velez-area	CITY	MISC	1
Velez-registered	CITY	MISC	1
Villanueva-headquartered	CITY	MISC	1
Villanueva-owned	CITY	MISC	1
Villanueva-controlled	CITY	MISC	1
Villanueva-raised	CITY	MISC	1
Villanueva-educated	CITY	MISC	1
Villanueva-backed	CITY	MISC	1
Villanueva-trained	CITY	MISC	1
Villanueva-born	CITY	MISC	1
Villanueva-area	CITY	MISC	1
Villanueva-registered	CITY	MISC	1
Walker-headquartered	CITY	MISC	1
Walker-owned	CITY	MISC	1
Walker-controlled	CITY	MISC	1
Walker-raised	CITY	MISC	1
Walker-educated	CITY	MISC	1
Walker-backed	CITY	MISC	1
Walker-trained	CITY	MISC	1
Walker-born	CITY	MISC	1
Walker-area	CITY	MISC	1
Walker-registered	CITY	MISC	1
Ware-headquartered	CITY	MISC	1
Ware-owned	CITY	MISC	1
Ware-controlled	CITY	MISC	1
Ware-raised	CITY	MISC	1
Ware-educated	CITY	MISC	1
Ware-backed	CITY	MISC	1
Ware-trained	CITY	MISC	1
Ware-born	CITY	MISC	1
Ware-area	CITY	MISC	1
Ware-registered	CITY	MISC	1
Warren-headquartered	CITY	MISC	1
Warren-owned	CITY	MISC	1
Warren-controlled	CITY	MISC	1
Warren-raised	CITY	MISC	1
Warren-educated	CITY	MISC	1
Warren-backed	CITY	MISC	1
Warren-trained	CITY	MISC	1
Warren-born	CITY	MISC	1
Warren-area	CITY	MISC	1
Warren-registered	CITY	MISC	1
Webster-headquartered	CITY	MISC	1
Webster-owned	CITY	MISC	1
Webster-controlled	CITY	MISC	1
Webster-raised	CITY	MISC	1
Webster-educated	CITY	MISC	1
Webster-backed	CITY	MISC	1
Webster-trained	CITY	MISC	1
Webster-born	CITY	MISC	1
Webster-area	CITY	MISC	1
Webster-registered	CITY	MISC	1
Wells-headquartered	CITY	MISC	1
Wells-owned	CITY	MISC	1
Wells-controlled	CITY	MISC	1
Wells-raised	CITY	MISC	1
Wells-educated	CITY	MISC	1
Wells-backed	CITY	MISC	1
Wells-trained	CITY	MISC	1
Wells-born	CITY	MISC	1
Wells-area	CITY	MISC	1
Wells-registered	CITY	MISC	1
Wilson-headquartered	CITY	MISC	1
Wilson-owned	CITY	MISC	1
Wilson-controlled	CITY	MISC	1
Wilson-raised	CITY	MISC	1
Wilson-educated	CITY	MISC	1
Wilson-backed	CITY	MISC	1
Wilson-trained	CITY	MISC	1
Wilson-born	CITY	MISC	1
Wilson-area	CITY	MISC	1
Wilson-registered	CITY	MISC	1
Woodward-headquartered	CITY	MISC	1
Woodward-owned	CITY	MISC	1
Woodward-controlled	CITY	MISC	1
Woodward-raised	CITY	MISC	1
Woodward-educated	CITY	MISC	1
Woodward-backed	CITY	MISC	1
Woodward-trained	CITY	MISC	1
Woodward-born	CITY	MISC	1
Woodward-area	CITY	MISC	1
Woodward-registered	CITY	MISC	1
Wright-headquartered	CITY	MISC	1
Wright-owned	CITY	MISC	1
Wright-controlled	CITY	MISC	1
Wright-raised	CITY	MISC	1
Wright-educated	CITY	MISC	1
Wright-backed	CITY	MISC	1
Wright-trained	CITY	MISC	1
Wright-born	CITY	MISC	1
Wright-area	CITY	MISC	1
Wright-registered	CITY	MISC	1
York-headquartered	CITY	MISC	1
York-owned	CITY	MISC	1
York-controlled	CITY	MISC	1
York-raised	CITY	MISC	1
York-educated	CITY	MISC	1
York-backed	CITY	MISC	1
York-trained	CITY	MISC	1
York-born	CITY	MISC	1
York-area	CITY	MISC	1
York-registered	CITY	MISC	1
Young-headquartered	CITY	MISC	1
Young-owned	CITY	MISC	1
Young-controlled	CITY	MISC	1
Young-raised	CITY	MISC	1
Young-educated	CITY	MISC	1
Young-backed	CITY	MISC	1
Young-trained	CITY	MISC	1
Young-born	CITY	MISC	1
Young-area	CITY	MISC	1
Young-registered	CITY	MISC	1
Zamora-headquartered	CITY	MISC	1
Zamora-owned	CITY	MISC	1
Zamora-controlled	CITY	MISC	1
Zamora-raised	CITY	MISC	1
Zamora-educated	CITY	MISC	1
Zamora-backed	CITY	MISC	1
Zamora-trained	CITY	MISC	1
Zamora-born	CITY	MISC	1
Zamora-area	CITY	MISC	1
Zamora-registered	CITY	MISC	1
